date,canton_code,canton_names,bag_falle,bag_tode,bag_cum_falle,bag_cum_tode,bag_hosp,bag_cum_hosp,date_t0,t,NUTS3
2020-02-24,AG,Aargau,0,0,0,0,0,0,2020-02-25,0,CH033
2020-02-25,AG,Aargau,1,0,1,0,1,1,2020-02-25,1,CH033
2020-02-26,AG,Aargau,0,0,1,0,0,1,2020-02-25,2,CH033
2020-02-27,AG,Aargau,0,0,1,0,0,1,2020-02-25,3,CH033
2020-02-28,AG,Aargau,0,0,1,0,0,1,2020-02-25,4,CH033
2020-02-29,AG,Aargau,2,0,3,0,2,3,2020-02-25,5,CH033
2020-03-01,AG,Aargau,2,0,5,0,0,3,2020-02-25,6,CH033
2020-03-02,AG,Aargau,1,0,6,0,2,5,2020-02-25,7,CH033
2020-03-03,AG,Aargau,1,0,7,0,1,6,2020-02-25,8,CH033
2020-03-04,AG,Aargau,3,0,10,0,3,9,2020-02-25,9,CH033
2020-03-05,AG,Aargau,2,0,12,0,0,9,2020-02-25,10,CH033
2020-03-06,AG,Aargau,2,0,14,0,0,9,2020-02-25,11,CH033
2020-03-07,AG,Aargau,0,0,14,0,0,9,2020-02-25,12,CH033
2020-03-08,AG,Aargau,1,0,15,0,0,9,2020-02-25,13,CH033
2020-03-09,AG,Aargau,3,0,18,0,0,9,2020-02-25,14,CH033
2020-03-10,AG,Aargau,3,0,21,0,0,9,2020-02-25,15,CH033
2020-03-11,AG,Aargau,7,0,28,0,0,9,2020-02-25,16,CH033
2020-03-12,AG,Aargau,7,0,35,0,1,10,2020-02-25,17,CH033
2020-03-13,AG,Aargau,6,0,41,0,1,11,2020-02-25,18,CH033
2020-03-14,AG,Aargau,10,0,51,0,2,13,2020-02-25,19,CH033
2020-03-15,AG,Aargau,8,0,59,0,2,15,2020-02-25,20,CH033
2020-03-16,AG,Aargau,33,0,92,0,5,20,2020-02-25,21,CH033
2020-03-17,AG,Aargau,36,0,128,0,3,23,2020-02-25,22,CH033
2020-03-18,AG,Aargau,35,0,163,0,5,28,2020-02-25,23,CH033
2020-03-19,AG,Aargau,32,1,195,1,2,30,2020-02-25,24,CH033
2020-03-20,AG,Aargau,37,0,232,1,2,32,2020-02-25,25,CH033
2020-03-21,AG,Aargau,11,0,243,1,1,33,2020-02-25,26,CH033
2020-03-22,AG,Aargau,9,0,252,1,1,34,2020-02-25,27,CH033
2020-03-23,AG,Aargau,42,1,294,2,8,42,2020-02-25,28,CH033
2020-03-24,AG,Aargau,54,0,348,2,8,50,2020-02-25,29,CH033
2020-03-25,AG,Aargau,46,0,394,2,9,59,2020-02-25,30,CH033
2020-03-26,AG,Aargau,35,1,429,3,14,73,2020-02-25,31,CH033
2020-03-27,AG,Aargau,54,2,483,5,5,78,2020-02-25,32,CH033
2020-03-28,AG,Aargau,22,3,505,8,6,84,2020-02-25,33,CH033
2020-03-29,AG,Aargau,18,1,523,9,6,90,2020-02-25,34,CH033
2020-03-30,AG,Aargau,59,2,582,11,4,94,2020-02-25,35,CH033
2020-03-31,AG,Aargau,42,0,624,11,6,100,2020-02-25,36,CH033
2020-04-01,AG,Aargau,37,0,661,11,0,100,2020-02-25,37,CH033
2020-04-02,AG,Aargau,33,3,694,14,5,105,2020-02-25,38,CH033
2020-04-03,AG,Aargau,40,1,734,15,6,111,2020-02-25,39,CH033
2020-04-04,AG,Aargau,23,3,757,18,2,113,2020-02-25,40,CH033
2020-04-05,AG,Aargau,11,1,768,19,3,116,2020-02-25,41,CH033
2020-04-06,AG,Aargau,43,0,811,19,7,123,2020-02-25,42,CH033
2020-04-07,AG,Aargau,35,0,846,19,7,130,2020-02-25,43,CH033
2020-04-08,AG,Aargau,22,3,868,22,1,131,2020-02-25,44,CH033
2020-04-09,AG,Aargau,25,0,893,22,3,134,2020-02-25,45,CH033
2020-04-10,AG,Aargau,11,3,904,25,0,134,2020-02-25,46,CH033
2020-04-11,AG,Aargau,5,1,909,26,2,136,2020-02-25,47,CH033
2020-04-12,AG,Aargau,8,0,917,26,2,138,2020-02-25,48,CH033
2020-04-13,AG,Aargau,12,0,929,26,0,138,2020-02-25,49,CH033
2020-04-14,AG,Aargau,24,2,953,28,3,141,2020-02-25,50,CH033
2020-04-15,AG,Aargau,16,0,969,28,1,142,2020-02-25,51,CH033
2020-04-16,AG,Aargau,19,1,988,29,1,143,2020-02-25,52,CH033
2020-04-17,AG,Aargau,23,0,1011,29,3,146,2020-02-25,53,CH033
2020-04-18,AG,Aargau,5,0,1016,29,0,146,2020-02-25,54,CH033
2020-04-19,AG,Aargau,0,0,1016,29,0,146,2020-02-25,55,CH033
2020-04-20,AG,Aargau,13,1,1029,30,1,147,2020-02-25,56,CH033
2020-04-21,AG,Aargau,15,2,1044,32,3,150,2020-02-25,57,CH033
2020-04-22,AG,Aargau,14,1,1058,33,0,150,2020-02-25,58,CH033
2020-04-23,AG,Aargau,12,1,1070,34,3,153,2020-02-25,59,CH033
2020-04-24,AG,Aargau,12,0,1082,34,0,153,2020-02-25,60,CH033
2020-04-25,AG,Aargau,5,1,1087,35,4,157,2020-02-25,61,CH033
2020-04-26,AG,Aargau,1,0,1088,35,0,157,2020-02-25,62,CH033
2020-04-27,AG,Aargau,11,0,1099,35,0,157,2020-02-25,63,CH033
2020-04-28,AG,Aargau,4,0,1103,35,2,159,2020-02-25,64,CH033
2020-04-29,AG,Aargau,9,2,1112,37,2,161,2020-02-25,65,CH033
2020-04-30,AG,Aargau,7,0,1119,37,0,161,2020-02-25,66,CH033
2020-05-01,AG,Aargau,5,1,1124,38,0,161,2020-02-25,67,CH033
2020-05-02,AG,Aargau,3,0,1127,38,1,162,2020-02-25,68,CH033
2020-05-03,AG,Aargau,0,0,1127,38,1,163,2020-02-25,69,CH033
2020-05-04,AG,Aargau,10,1,1137,39,0,163,2020-02-25,70,CH033
2020-05-05,AG,Aargau,3,0,1140,39,0,163,2020-02-25,71,CH033
2020-05-06,AG,Aargau,4,0,1144,39,1,164,2020-02-25,72,CH033
2020-05-07,AG,Aargau,2,0,1146,39,0,164,2020-02-25,73,CH033
2020-05-08,AG,Aargau,5,1,1151,40,1,165,2020-02-25,74,CH033
2020-05-09,AG,Aargau,6,0,1157,40,0,165,2020-02-25,75,CH033
2020-05-10,AG,Aargau,2,1,1159,41,0,165,2020-02-25,76,CH033
2020-05-11,AG,Aargau,2,0,1161,41,0,165,2020-02-25,77,CH033
2020-05-12,AG,Aargau,4,0,1165,41,0,165,2020-02-25,78,CH033
2020-05-13,AG,Aargau,5,0,1170,41,1,166,2020-02-25,79,CH033
2020-05-14,AG,Aargau,2,0,1172,41,0,166,2020-02-25,80,CH033
2020-05-15,AG,Aargau,3,1,1175,42,1,167,2020-02-25,81,CH033
2020-05-16,AG,Aargau,4,0,1179,42,0,167,2020-02-25,82,CH033
2020-05-17,AG,Aargau,0,0,1179,42,1,168,2020-02-25,83,CH033
2020-05-18,AG,Aargau,4,0,1183,42,1,169,2020-02-25,84,CH033
2020-05-19,AG,Aargau,3,0,1186,42,0,169,2020-02-25,85,CH033
2020-05-20,AG,Aargau,0,0,1186,42,0,169,2020-02-25,86,CH033
2020-05-21,AG,Aargau,0,0,1186,42,0,169,2020-02-25,87,CH033
2020-05-22,AG,Aargau,0,0,1186,42,0,169,2020-02-25,88,CH033
2020-05-23,AG,Aargau,0,0,1186,42,0,169,2020-02-25,89,CH033
2020-02-24,AI,Appenzell Innerrhoden,0,0,0,0,0,0,2020-03-13,-17,CH054
2020-02-25,AI,Appenzell Innerrhoden,0,0,0,0,0,0,2020-03-13,-16,CH054
2020-02-26,AI,Appenzell Innerrhoden,0,0,0,0,0,0,2020-03-13,-15,CH054
2020-02-27,AI,Appenzell Innerrhoden,0,0,0,0,0,0,2020-03-13,-14,CH054
2020-02-28,AI,Appenzell Innerrhoden,0,0,0,0,0,0,2020-03-13,-13,CH054
2020-02-29,AI,Appenzell Innerrhoden,0,0,0,0,0,0,2020-03-13,-12,CH054
2020-03-01,AI,Appenzell Innerrhoden,0,0,0,0,0,0,2020-03-13,-11,CH054
2020-03-02,AI,Appenzell Innerrhoden,0,0,0,0,0,0,2020-03-13,-10,CH054
2020-03-03,AI,Appenzell Innerrhoden,0,0,0,0,0,0,2020-03-13,-9,CH054
2020-03-04,AI,Appenzell Innerrhoden,0,0,0,0,0,0,2020-03-13,-8,CH054
2020-03-05,AI,Appenzell Innerrhoden,0,0,0,0,0,0,2020-03-13,-7,CH054
2020-03-06,AI,Appenzell Innerrhoden,0,0,0,0,0,0,2020-03-13,-6,CH054
2020-03-07,AI,Appenzell Innerrhoden,0,0,0,0,0,0,2020-03-13,-5,CH054
2020-03-08,AI,Appenzell Innerrhoden,0,0,0,0,0,0,2020-03-13,-4,CH054
2020-03-09,AI,Appenzell Innerrhoden,0,0,0,0,0,0,2020-03-13,-3,CH054
2020-03-10,AI,Appenzell Innerrhoden,0,0,0,0,0,0,2020-03-13,-2,CH054
2020-03-11,AI,Appenzell Innerrhoden,0,0,0,0,0,0,2020-03-13,-1,CH054
2020-03-12,AI,Appenzell Innerrhoden,0,0,0,0,0,0,2020-03-13,0,CH054
2020-03-13,AI,Appenzell Innerrhoden,2,0,2,0,0,0,2020-03-13,1,CH054
2020-03-14,AI,Appenzell Innerrhoden,0,0,2,0,0,0,2020-03-13,2,CH054
2020-03-15,AI,Appenzell Innerrhoden,0,0,2,0,0,0,2020-03-13,3,CH054
2020-03-16,AI,Appenzell Innerrhoden,1,0,3,0,0,0,2020-03-13,4,CH054
2020-03-17,AI,Appenzell Innerrhoden,0,0,3,0,0,0,2020-03-13,5,CH054
2020-03-18,AI,Appenzell Innerrhoden,0,0,3,0,0,0,2020-03-13,6,CH054
2020-03-19,AI,Appenzell Innerrhoden,1,0,4,0,2,2,2020-03-13,7,CH054
2020-03-20,AI,Appenzell Innerrhoden,1,0,5,0,0,2,2020-03-13,8,CH054
2020-03-21,AI,Appenzell Innerrhoden,0,0,5,0,0,2,2020-03-13,9,CH054
2020-03-22,AI,Appenzell Innerrhoden,0,0,5,0,0,2,2020-03-13,10,CH054
2020-03-23,AI,Appenzell Innerrhoden,0,0,5,0,0,2,2020-03-13,11,CH054
2020-03-24,AI,Appenzell Innerrhoden,2,0,7,0,0,2,2020-03-13,12,CH054
2020-03-25,AI,Appenzell Innerrhoden,0,0,7,0,0,2,2020-03-13,13,CH054
2020-03-26,AI,Appenzell Innerrhoden,0,0,7,0,0,2,2020-03-13,14,CH054
2020-03-27,AI,Appenzell Innerrhoden,2,0,9,0,0,2,2020-03-13,15,CH054
2020-03-28,AI,Appenzell Innerrhoden,1,0,10,0,0,2,2020-03-13,16,CH054
2020-03-29,AI,Appenzell Innerrhoden,0,0,10,0,0,2,2020-03-13,17,CH054
2020-03-30,AI,Appenzell Innerrhoden,0,0,10,0,0,2,2020-03-13,18,CH054
2020-03-31,AI,Appenzell Innerrhoden,3,0,13,0,0,2,2020-03-13,19,CH054
2020-04-01,AI,Appenzell Innerrhoden,3,0,16,0,0,2,2020-03-13,20,CH054
2020-04-02,AI,Appenzell Innerrhoden,0,0,16,0,0,2,2020-03-13,21,CH054
2020-04-03,AI,Appenzell Innerrhoden,1,0,17,0,0,2,2020-03-13,22,CH054
2020-04-04,AI,Appenzell Innerrhoden,0,0,17,0,0,2,2020-03-13,23,CH054
2020-04-05,AI,Appenzell Innerrhoden,0,0,17,0,0,2,2020-03-13,24,CH054
2020-04-06,AI,Appenzell Innerrhoden,0,0,17,0,0,2,2020-03-13,25,CH054
2020-04-07,AI,Appenzell Innerrhoden,1,0,18,0,0,2,2020-03-13,26,CH054
2020-04-08,AI,Appenzell Innerrhoden,1,0,19,0,0,2,2020-03-13,27,CH054
2020-04-09,AI,Appenzell Innerrhoden,0,0,19,0,0,2,2020-03-13,28,CH054
2020-04-10,AI,Appenzell Innerrhoden,0,0,19,0,0,2,2020-03-13,29,CH054
2020-04-11,AI,Appenzell Innerrhoden,0,0,19,0,0,2,2020-03-13,30,CH054
2020-04-12,AI,Appenzell Innerrhoden,0,0,19,0,0,2,2020-03-13,31,CH054
2020-04-13,AI,Appenzell Innerrhoden,0,0,19,0,0,2,2020-03-13,32,CH054
2020-04-14,AI,Appenzell Innerrhoden,0,0,19,0,0,2,2020-03-13,33,CH054
2020-04-15,AI,Appenzell Innerrhoden,0,0,19,0,0,2,2020-03-13,34,CH054
2020-04-16,AI,Appenzell Innerrhoden,0,0,19,0,0,2,2020-03-13,35,CH054
2020-04-17,AI,Appenzell Innerrhoden,0,0,19,0,0,2,2020-03-13,36,CH054
2020-04-18,AI,Appenzell Innerrhoden,0,0,19,0,0,2,2020-03-13,37,CH054
2020-04-19,AI,Appenzell Innerrhoden,0,0,19,0,0,2,2020-03-13,38,CH054
2020-04-20,AI,Appenzell Innerrhoden,0,0,19,0,0,2,2020-03-13,39,CH054
2020-04-21,AI,Appenzell Innerrhoden,0,0,19,0,0,2,2020-03-13,40,CH054
2020-04-22,AI,Appenzell Innerrhoden,1,0,20,0,0,2,2020-03-13,41,CH054
2020-04-23,AI,Appenzell Innerrhoden,0,0,20,0,0,2,2020-03-13,42,CH054
2020-04-24,AI,Appenzell Innerrhoden,0,0,20,0,0,2,2020-03-13,43,CH054
2020-04-25,AI,Appenzell Innerrhoden,0,0,20,0,0,2,2020-03-13,44,CH054
2020-04-26,AI,Appenzell Innerrhoden,0,0,20,0,0,2,2020-03-13,45,CH054
2020-04-27,AI,Appenzell Innerrhoden,0,0,20,0,0,2,2020-03-13,46,CH054
2020-04-28,AI,Appenzell Innerrhoden,0,0,20,0,0,2,2020-03-13,47,CH054
2020-04-29,AI,Appenzell Innerrhoden,0,0,20,0,0,2,2020-03-13,48,CH054
2020-04-30,AI,Appenzell Innerrhoden,0,0,20,0,0,2,2020-03-13,49,CH054
2020-05-01,AI,Appenzell Innerrhoden,0,0,20,0,0,2,2020-03-13,50,CH054
2020-05-02,AI,Appenzell Innerrhoden,0,0,20,0,0,2,2020-03-13,51,CH054
2020-05-03,AI,Appenzell Innerrhoden,0,0,20,0,0,2,2020-03-13,52,CH054
2020-05-04,AI,Appenzell Innerrhoden,0,0,20,0,0,2,2020-03-13,53,CH054
2020-05-05,AI,Appenzell Innerrhoden,0,0,20,0,0,2,2020-03-13,54,CH054
2020-05-06,AI,Appenzell Innerrhoden,0,0,20,0,0,2,2020-03-13,55,CH054
2020-05-07,AI,Appenzell Innerrhoden,0,0,20,0,0,2,2020-03-13,56,CH054
2020-05-08,AI,Appenzell Innerrhoden,0,0,20,0,0,2,2020-03-13,57,CH054
2020-05-09,AI,Appenzell Innerrhoden,0,0,20,0,0,2,2020-03-13,58,CH054
2020-05-10,AI,Appenzell Innerrhoden,0,0,20,0,0,2,2020-03-13,59,CH054
2020-05-11,AI,Appenzell Innerrhoden,0,0,20,0,0,2,2020-03-13,60,CH054
2020-05-12,AI,Appenzell Innerrhoden,0,0,20,0,0,2,2020-03-13,61,CH054
2020-05-13,AI,Appenzell Innerrhoden,0,0,20,0,0,2,2020-03-13,62,CH054
2020-05-14,AI,Appenzell Innerrhoden,0,0,20,0,0,2,2020-03-13,63,CH054
2020-05-15,AI,Appenzell Innerrhoden,0,0,20,0,0,2,2020-03-13,64,CH054
2020-05-16,AI,Appenzell Innerrhoden,0,0,20,0,0,2,2020-03-13,65,CH054
2020-05-17,AI,Appenzell Innerrhoden,0,0,20,0,0,2,2020-03-13,66,CH054
2020-05-18,AI,Appenzell Innerrhoden,0,0,20,0,0,2,2020-03-13,67,CH054
2020-05-19,AI,Appenzell Innerrhoden,0,0,20,0,0,2,2020-03-13,68,CH054
2020-05-20,AI,Appenzell Innerrhoden,0,0,20,0,0,2,2020-03-13,69,CH054
2020-05-21,AI,Appenzell Innerrhoden,0,0,20,0,0,2,2020-03-13,70,CH054
2020-05-22,AI,Appenzell Innerrhoden,0,0,20,0,0,2,2020-03-13,71,CH054
2020-05-23,AI,Appenzell Innerrhoden,0,0,20,0,0,2,2020-03-13,72,CH054
2020-02-24,AR,Appenzell Ausserrhoden,0,0,0,0,0,0,2020-03-04,-8,CH053
2020-02-25,AR,Appenzell Ausserrhoden,0,0,0,0,0,0,2020-03-04,-7,CH053
2020-02-26,AR,Appenzell Ausserrhoden,0,0,0,0,0,0,2020-03-04,-6,CH053
2020-02-27,AR,Appenzell Ausserrhoden,0,0,0,0,0,0,2020-03-04,-5,CH053
2020-02-28,AR,Appenzell Ausserrhoden,0,0,0,0,0,0,2020-03-04,-4,CH053
2020-02-29,AR,Appenzell Ausserrhoden,0,0,0,0,0,0,2020-03-04,-3,CH053
2020-03-01,AR,Appenzell Ausserrhoden,0,0,0,0,0,0,2020-03-04,-2,CH053
2020-03-02,AR,Appenzell Ausserrhoden,0,0,0,0,0,0,2020-03-04,-1,CH053
2020-03-03,AR,Appenzell Ausserrhoden,0,0,0,0,0,0,2020-03-04,0,CH053
2020-03-04,AR,Appenzell Ausserrhoden,1,0,1,0,0,0,2020-03-04,1,CH053
2020-03-05,AR,Appenzell Ausserrhoden,0,0,1,0,0,0,2020-03-04,2,CH053
2020-03-06,AR,Appenzell Ausserrhoden,0,0,1,0,0,0,2020-03-04,3,CH053
2020-03-07,AR,Appenzell Ausserrhoden,0,0,1,0,0,0,2020-03-04,4,CH053
2020-03-08,AR,Appenzell Ausserrhoden,1,0,2,0,0,0,2020-03-04,5,CH053
2020-03-09,AR,Appenzell Ausserrhoden,1,0,3,0,0,0,2020-03-04,6,CH053
2020-03-10,AR,Appenzell Ausserrhoden,0,0,3,0,0,0,2020-03-04,7,CH053
2020-03-11,AR,Appenzell Ausserrhoden,2,0,5,0,1,1,2020-03-04,8,CH053
2020-03-12,AR,Appenzell Ausserrhoden,0,0,5,0,0,1,2020-03-04,9,CH053
2020-03-13,AR,Appenzell Ausserrhoden,1,0,6,0,0,1,2020-03-04,10,CH053
2020-03-14,AR,Appenzell Ausserrhoden,3,0,9,0,0,1,2020-03-04,11,CH053
2020-03-15,AR,Appenzell Ausserrhoden,1,0,10,0,0,1,2020-03-04,12,CH053
2020-03-16,AR,Appenzell Ausserrhoden,5,0,15,0,2,3,2020-03-04,13,CH053
2020-03-17,AR,Appenzell Ausserrhoden,2,0,17,0,3,6,2020-03-04,14,CH053
2020-03-18,AR,Appenzell Ausserrhoden,4,0,21,0,0,6,2020-03-04,15,CH053
2020-03-19,AR,Appenzell Ausserrhoden,7,0,28,0,1,7,2020-03-04,16,CH053
2020-03-20,AR,Appenzell Ausserrhoden,2,0,30,0,0,7,2020-03-04,17,CH053
2020-03-21,AR,Appenzell Ausserrhoden,1,1,31,1,0,7,2020-03-04,18,CH053
2020-03-22,AR,Appenzell Ausserrhoden,0,0,31,1,0,7,2020-03-04,19,CH053
2020-03-23,AR,Appenzell Ausserrhoden,3,1,34,2,0,7,2020-03-04,20,CH053
2020-03-24,AR,Appenzell Ausserrhoden,3,0,37,2,0,7,2020-03-04,21,CH053
2020-03-25,AR,Appenzell Ausserrhoden,3,0,40,2,1,8,2020-03-04,22,CH053
2020-03-26,AR,Appenzell Ausserrhoden,3,0,43,2,0,8,2020-03-04,23,CH053
2020-03-27,AR,Appenzell Ausserrhoden,2,0,45,2,0,8,2020-03-04,24,CH053
2020-03-28,AR,Appenzell Ausserrhoden,4,0,49,2,1,9,2020-03-04,25,CH053
2020-03-29,AR,Appenzell Ausserrhoden,2,0,51,2,0,9,2020-03-04,26,CH053
2020-03-30,AR,Appenzell Ausserrhoden,4,0,55,2,1,10,2020-03-04,27,CH053
2020-03-31,AR,Appenzell Ausserrhoden,5,0,60,2,3,13,2020-03-04,28,CH053
2020-04-01,AR,Appenzell Ausserrhoden,2,1,62,3,0,13,2020-03-04,29,CH053
2020-04-02,AR,Appenzell Ausserrhoden,2,0,64,3,0,13,2020-03-04,30,CH053
2020-04-03,AR,Appenzell Ausserrhoden,1,0,65,3,0,13,2020-03-04,31,CH053
2020-04-04,AR,Appenzell Ausserrhoden,1,0,66,3,1,14,2020-03-04,32,CH053
2020-04-05,AR,Appenzell Ausserrhoden,1,0,67,3,0,14,2020-03-04,33,CH053
2020-04-06,AR,Appenzell Ausserrhoden,2,0,69,3,0,14,2020-03-04,34,CH053
2020-04-07,AR,Appenzell Ausserrhoden,3,0,72,3,0,14,2020-03-04,35,CH053
2020-04-08,AR,Appenzell Ausserrhoden,2,0,74,3,0,14,2020-03-04,36,CH053
2020-04-09,AR,Appenzell Ausserrhoden,1,0,75,3,0,14,2020-03-04,37,CH053
2020-04-10,AR,Appenzell Ausserrhoden,0,0,75,3,0,14,2020-03-04,38,CH053
2020-04-11,AR,Appenzell Ausserrhoden,0,0,75,3,1,15,2020-03-04,39,CH053
2020-04-12,AR,Appenzell Ausserrhoden,0,0,75,3,0,15,2020-03-04,40,CH053
2020-04-13,AR,Appenzell Ausserrhoden,0,0,75,3,0,15,2020-03-04,41,CH053
2020-04-14,AR,Appenzell Ausserrhoden,0,0,75,3,0,15,2020-03-04,42,CH053
2020-04-15,AR,Appenzell Ausserrhoden,1,0,76,3,0,15,2020-03-04,43,CH053
2020-04-16,AR,Appenzell Ausserrhoden,0,0,76,3,0,15,2020-03-04,44,CH053
2020-04-17,AR,Appenzell Ausserrhoden,2,0,78,3,0,15,2020-03-04,45,CH053
2020-04-18,AR,Appenzell Ausserrhoden,1,0,79,3,1,16,2020-03-04,46,CH053
2020-04-19,AR,Appenzell Ausserrhoden,0,0,79,3,1,17,2020-03-04,47,CH053
2020-04-20,AR,Appenzell Ausserrhoden,2,0,81,3,0,17,2020-03-04,48,CH053
2020-04-21,AR,Appenzell Ausserrhoden,2,0,83,3,1,18,2020-03-04,49,CH053
2020-04-22,AR,Appenzell Ausserrhoden,1,0,84,3,0,18,2020-03-04,50,CH053
2020-04-23,AR,Appenzell Ausserrhoden,1,0,85,3,0,18,2020-03-04,51,CH053
2020-04-24,AR,Appenzell Ausserrhoden,2,0,87,3,1,19,2020-03-04,52,CH053
2020-04-25,AR,Appenzell Ausserrhoden,0,0,87,3,0,19,2020-03-04,53,CH053
2020-04-26,AR,Appenzell Ausserrhoden,0,0,87,3,0,19,2020-03-04,54,CH053
2020-04-27,AR,Appenzell Ausserrhoden,0,0,87,3,0,19,2020-03-04,55,CH053
2020-04-28,AR,Appenzell Ausserrhoden,0,0,87,3,1,20,2020-03-04,56,CH053
2020-04-29,AR,Appenzell Ausserrhoden,1,0,88,3,0,20,2020-03-04,57,CH053
2020-04-30,AR,Appenzell Ausserrhoden,1,0,89,3,0,20,2020-03-04,58,CH053
2020-05-01,AR,Appenzell Ausserrhoden,0,0,89,3,0,20,2020-03-04,59,CH053
2020-05-02,AR,Appenzell Ausserrhoden,0,0,89,3,0,20,2020-03-04,60,CH053
2020-05-03,AR,Appenzell Ausserrhoden,0,0,89,3,1,21,2020-03-04,61,CH053
2020-05-04,AR,Appenzell Ausserrhoden,0,0,89,3,0,21,2020-03-04,62,CH053
2020-05-05,AR,Appenzell Ausserrhoden,0,0,89,3,0,21,2020-03-04,63,CH053
2020-05-06,AR,Appenzell Ausserrhoden,0,0,89,3,0,21,2020-03-04,64,CH053
2020-05-07,AR,Appenzell Ausserrhoden,0,0,89,3,0,21,2020-03-04,65,CH053
2020-05-08,AR,Appenzell Ausserrhoden,1,0,90,3,0,21,2020-03-04,66,CH053
2020-05-09,AR,Appenzell Ausserrhoden,0,0,90,3,0,21,2020-03-04,67,CH053
2020-05-10,AR,Appenzell Ausserrhoden,0,0,90,3,0,21,2020-03-04,68,CH053
2020-05-11,AR,Appenzell Ausserrhoden,0,0,90,3,0,21,2020-03-04,69,CH053
2020-05-12,AR,Appenzell Ausserrhoden,0,0,90,3,0,21,2020-03-04,70,CH053
2020-05-13,AR,Appenzell Ausserrhoden,1,0,91,3,1,22,2020-03-04,71,CH053
2020-05-14,AR,Appenzell Ausserrhoden,0,0,91,3,0,22,2020-03-04,72,CH053
2020-05-15,AR,Appenzell Ausserrhoden,0,0,91,3,0,22,2020-03-04,73,CH053
2020-05-16,AR,Appenzell Ausserrhoden,0,0,91,3,0,22,2020-03-04,74,CH053
2020-05-17,AR,Appenzell Ausserrhoden,0,0,91,3,0,22,2020-03-04,75,CH053
2020-05-18,AR,Appenzell Ausserrhoden,0,0,91,3,0,22,2020-03-04,76,CH053
2020-05-19,AR,Appenzell Ausserrhoden,0,0,91,3,0,22,2020-03-04,77,CH053
2020-05-20,AR,Appenzell Ausserrhoden,0,0,91,3,0,22,2020-03-04,78,CH053
2020-05-21,AR,Appenzell Ausserrhoden,0,0,91,3,0,22,2020-03-04,79,CH053
2020-05-22,AR,Appenzell Ausserrhoden,0,0,91,3,0,22,2020-03-04,80,CH053
2020-05-23,AR,Appenzell Ausserrhoden,0,0,91,3,0,22,2020-03-04,81,CH053
2020-02-24,BE,Bern,0,0,0,0,0,0,2020-02-27,-2,CH021
2020-02-25,BE,Bern,0,0,0,0,0,0,2020-02-27,-1,CH021
2020-02-26,BE,Bern,0,0,0,0,0,0,2020-02-27,0,CH021
2020-02-27,BE,Bern,1,0,1,0,0,0,2020-02-27,1,CH021
2020-02-28,BE,Bern,0,0,1,0,1,1,2020-02-27,2,CH021
2020-02-29,BE,Bern,1,0,2,0,1,2,2020-02-27,3,CH021
2020-03-01,BE,Bern,0,0,2,0,1,3,2020-02-27,4,CH021
2020-03-02,BE,Bern,4,0,6,0,2,5,2020-02-27,5,CH021
2020-03-03,BE,Bern,3,0,9,0,1,6,2020-02-27,6,CH021
2020-03-04,BE,Bern,8,0,17,0,0,6,2020-02-27,7,CH021
2020-03-05,BE,Bern,5,0,22,0,1,7,2020-02-27,8,CH021
2020-03-06,BE,Bern,9,0,31,0,3,10,2020-02-27,9,CH021
2020-03-07,BE,Bern,0,0,31,0,0,10,2020-02-27,10,CH021
2020-03-08,BE,Bern,3,0,34,0,1,11,2020-02-27,11,CH021
2020-03-09,BE,Bern,4,0,38,0,0,11,2020-02-27,12,CH021
2020-03-10,BE,Bern,7,0,45,0,1,12,2020-02-27,13,CH021
2020-03-11,BE,Bern,16,0,61,0,4,16,2020-02-27,14,CH021
2020-03-12,BE,Bern,24,0,85,0,1,17,2020-02-27,15,CH021
2020-03-13,BE,Bern,11,0,96,0,2,19,2020-02-27,16,CH021
2020-03-14,BE,Bern,19,0,115,0,0,19,2020-02-27,17,CH021
2020-03-15,BE,Bern,20,0,135,0,0,19,2020-02-27,18,CH021
2020-03-16,BE,Bern,69,1,204,1,10,29,2020-02-27,19,CH021
2020-03-17,BE,Bern,54,1,258,2,7,36,2020-02-27,20,CH021
2020-03-18,BE,Bern,62,0,320,2,8,44,2020-02-27,21,CH021
2020-03-19,BE,Bern,52,0,372,2,2,46,2020-02-27,22,CH021
2020-03-20,BE,Bern,61,1,433,3,6,52,2020-02-27,23,CH021
2020-03-21,BE,Bern,42,2,475,5,6,58,2020-02-27,24,CH021
2020-03-22,BE,Bern,35,1,510,6,5,63,2020-02-27,25,CH021
2020-03-23,BE,Bern,69,0,579,6,12,75,2020-02-27,26,CH021
2020-03-24,BE,Bern,54,0,633,6,13,88,2020-02-27,27,CH021
2020-03-25,BE,Bern,58,1,691,7,10,98,2020-02-27,28,CH021
2020-03-26,BE,Bern,54,2,745,9,6,104,2020-02-27,29,CH021
2020-03-27,BE,Bern,81,0,826,9,9,113,2020-02-27,30,CH021
2020-03-28,BE,Bern,24,4,850,13,10,123,2020-02-27,31,CH021
2020-03-29,BE,Bern,21,2,871,15,6,129,2020-02-27,32,CH021
2020-03-30,BE,Bern,74,5,945,20,9,138,2020-02-27,33,CH021
2020-03-31,BE,Bern,72,1,1017,21,7,145,2020-02-27,34,CH021
2020-04-01,BE,Bern,57,3,1074,24,3,148,2020-02-27,35,CH021
2020-04-02,BE,Bern,43,2,1117,26,6,154,2020-02-27,36,CH021
2020-04-03,BE,Bern,63,0,1180,26,4,158,2020-02-27,37,CH021
2020-04-04,BE,Bern,40,3,1220,29,5,163,2020-02-27,38,CH021
2020-04-05,BE,Bern,14,4,1234,33,4,167,2020-02-27,39,CH021
2020-04-06,BE,Bern,71,0,1305,33,2,169,2020-02-27,40,CH021
2020-04-07,BE,Bern,52,4,1357,37,1,170,2020-02-27,41,CH021
2020-04-08,BE,Bern,59,4,1416,41,2,172,2020-02-27,42,CH021
2020-04-09,BE,Bern,21,4,1437,45,1,173,2020-02-27,43,CH021
2020-04-10,BE,Bern,16,5,1453,50,4,177,2020-02-27,44,CH021
2020-04-11,BE,Bern,21,3,1474,53,2,179,2020-02-27,45,CH021
2020-04-12,BE,Bern,11,2,1485,55,2,181,2020-02-27,46,CH021
2020-04-13,BE,Bern,17,5,1502,60,4,185,2020-02-27,47,CH021
2020-04-14,BE,Bern,36,2,1538,62,4,189,2020-02-27,48,CH021
2020-04-15,BE,Bern,31,2,1569,64,0,189,2020-02-27,49,CH021
2020-04-16,BE,Bern,20,1,1589,65,1,190,2020-02-27,50,CH021
2020-04-17,BE,Bern,16,1,1605,66,1,191,2020-02-27,51,CH021
2020-04-18,BE,Bern,8,2,1613,68,2,193,2020-02-27,52,CH021
2020-04-19,BE,Bern,10,0,1623,68,1,194,2020-02-27,53,CH021
2020-04-20,BE,Bern,29,4,1652,72,1,195,2020-02-27,54,CH021
2020-04-21,BE,Bern,19,2,1671,74,0,195,2020-02-27,55,CH021
2020-04-22,BE,Bern,10,1,1681,75,1,196,2020-02-27,56,CH021
2020-04-23,BE,Bern,19,2,1700,77,1,197,2020-02-27,57,CH021
2020-04-24,BE,Bern,10,1,1710,78,1,198,2020-02-27,58,CH021
2020-04-25,BE,Bern,4,1,1714,79,0,198,2020-02-27,59,CH021
2020-04-26,BE,Bern,9,0,1723,79,0,198,2020-02-27,60,CH021
2020-04-27,BE,Bern,14,0,1737,79,1,199,2020-02-27,61,CH021
2020-04-28,BE,Bern,9,2,1746,81,0,199,2020-02-27,62,CH021
2020-04-29,BE,Bern,9,0,1755,81,2,201,2020-02-27,63,CH021
2020-04-30,BE,Bern,10,1,1765,82,0,201,2020-02-27,64,CH021
2020-05-01,BE,Bern,11,0,1776,82,2,203,2020-02-27,65,CH021
2020-05-02,BE,Bern,6,0,1782,82,0,203,2020-02-27,66,CH021
2020-05-03,BE,Bern,2,0,1784,82,0,203,2020-02-27,67,CH021
2020-05-04,BE,Bern,6,0,1790,82,1,204,2020-02-27,68,CH021
2020-05-05,BE,Bern,3,0,1793,82,1,205,2020-02-27,69,CH021
2020-05-06,BE,Bern,8,0,1801,82,1,206,2020-02-27,70,CH021
2020-05-07,BE,Bern,6,0,1807,82,0,206,2020-02-27,71,CH021
2020-05-08,BE,Bern,5,0,1812,82,1,207,2020-02-27,72,CH021
2020-05-09,BE,Bern,5,0,1817,82,0,207,2020-02-27,73,CH021
2020-05-10,BE,Bern,2,1,1819,83,0,207,2020-02-27,74,CH021
2020-05-11,BE,Bern,2,0,1821,83,1,208,2020-02-27,75,CH021
2020-05-12,BE,Bern,3,0,1824,83,0,208,2020-02-27,76,CH021
2020-05-13,BE,Bern,5,0,1829,83,1,209,2020-02-27,77,CH021
2020-05-14,BE,Bern,6,0,1835,83,1,210,2020-02-27,78,CH021
2020-05-15,BE,Bern,3,0,1838,83,0,210,2020-02-27,79,CH021
2020-05-16,BE,Bern,0,0,1838,83,0,210,2020-02-27,80,CH021
2020-05-17,BE,Bern,0,0,1838,83,0,210,2020-02-27,81,CH021
2020-05-18,BE,Bern,3,0,1841,83,0,210,2020-02-27,82,CH021
2020-05-19,BE,Bern,2,0,1843,83,1,211,2020-02-27,83,CH021
2020-05-20,BE,Bern,0,0,1843,83,0,211,2020-02-27,84,CH021
2020-05-21,BE,Bern,0,0,1843,83,0,211,2020-02-27,85,CH021
2020-05-22,BE,Bern,0,0,1843,83,0,211,2020-02-27,86,CH021
2020-05-23,BE,Bern,0,0,1843,83,0,211,2020-02-27,87,CH021
2020-02-24,BL,Basel-Landschaft,0,0,0,0,0,0,2020-02-26,-1,CH032
2020-02-25,BL,Basel-Landschaft,0,0,0,0,0,0,2020-02-26,0,CH032
2020-02-26,BL,Basel-Landschaft,1,0,1,0,1,1,2020-02-26,1,CH032
2020-02-27,BL,Basel-Landschaft,0,0,1,0,1,2,2020-02-26,2,CH032
2020-02-28,BL,Basel-Landschaft,2,0,3,0,0,2,2020-02-26,3,CH032
2020-02-29,BL,Basel-Landschaft,1,0,4,0,1,3,2020-02-26,4,CH032
2020-03-01,BL,Basel-Landschaft,0,0,4,0,0,3,2020-02-26,5,CH032
2020-03-02,BL,Basel-Landschaft,0,0,4,0,0,3,2020-02-26,6,CH032
2020-03-03,BL,Basel-Landschaft,0,0,4,0,1,4,2020-02-26,7,CH032
2020-03-04,BL,Basel-Landschaft,2,0,6,0,0,4,2020-02-26,8,CH032
2020-03-05,BL,Basel-Landschaft,3,0,9,0,1,5,2020-02-26,9,CH032
2020-03-06,BL,Basel-Landschaft,8,0,17,0,0,5,2020-02-26,10,CH032
2020-03-07,BL,Basel-Landschaft,1,0,18,0,0,5,2020-02-26,11,CH032
2020-03-08,BL,Basel-Landschaft,0,1,18,1,0,5,2020-02-26,12,CH032
2020-03-09,BL,Basel-Landschaft,3,0,21,1,1,6,2020-02-26,13,CH032
2020-03-10,BL,Basel-Landschaft,4,0,25,1,2,8,2020-02-26,14,CH032
2020-03-11,BL,Basel-Landschaft,15,1,40,2,2,10,2020-02-26,15,CH032
2020-03-12,BL,Basel-Landschaft,12,0,52,2,2,12,2020-02-26,16,CH032
2020-03-13,BL,Basel-Landschaft,23,0,75,2,1,13,2020-02-26,17,CH032
2020-03-14,BL,Basel-Landschaft,8,0,83,2,1,14,2020-02-26,18,CH032
2020-03-15,BL,Basel-Landschaft,13,0,96,2,3,17,2020-02-26,19,CH032
2020-03-16,BL,Basel-Landschaft,33,0,129,2,8,25,2020-02-26,20,CH032
2020-03-17,BL,Basel-Landschaft,25,0,154,2,1,26,2020-02-26,21,CH032
2020-03-18,BL,Basel-Landschaft,38,0,192,2,3,29,2020-02-26,22,CH032
2020-03-19,BL,Basel-Landschaft,33,0,225,2,6,35,2020-02-26,23,CH032
2020-03-20,BL,Basel-Landschaft,49,1,274,3,9,44,2020-02-26,24,CH032
2020-03-21,BL,Basel-Landschaft,25,0,299,3,9,53,2020-02-26,25,CH032
2020-03-22,BL,Basel-Landschaft,22,0,321,3,8,61,2020-02-26,26,CH032
2020-03-23,BL,Basel-Landschaft,37,1,358,4,8,69,2020-02-26,27,CH032
2020-03-24,BL,Basel-Landschaft,50,1,408,5,4,73,2020-02-26,28,CH032
2020-03-25,BL,Basel-Landschaft,48,0,456,5,8,81,2020-02-26,29,CH032
2020-03-26,BL,Basel-Landschaft,34,0,490,5,7,88,2020-02-26,30,CH032
2020-03-27,BL,Basel-Landschaft,41,1,531,6,3,91,2020-02-26,31,CH032
2020-03-28,BL,Basel-Landschaft,23,2,554,8,9,100,2020-02-26,32,CH032
2020-03-29,BL,Basel-Landschaft,9,1,563,9,3,103,2020-02-26,33,CH032
2020-03-30,BL,Basel-Landschaft,38,2,601,11,6,109,2020-02-26,34,CH032
2020-03-31,BL,Basel-Landschaft,30,1,631,12,3,112,2020-02-26,35,CH032
2020-04-01,BL,Basel-Landschaft,18,3,649,15,3,115,2020-02-26,36,CH032
2020-04-02,BL,Basel-Landschaft,18,3,667,18,6,121,2020-02-26,37,CH032
2020-04-03,BL,Basel-Landschaft,21,1,688,19,7,128,2020-02-26,38,CH032
2020-04-04,BL,Basel-Landschaft,15,0,703,19,2,130,2020-02-26,39,CH032
2020-04-05,BL,Basel-Landschaft,10,0,713,19,2,132,2020-02-26,40,CH032
2020-04-06,BL,Basel-Landschaft,18,0,731,19,3,135,2020-02-26,41,CH032
2020-04-07,BL,Basel-Landschaft,21,1,752,20,5,140,2020-02-26,42,CH032
2020-04-08,BL,Basel-Landschaft,15,0,767,20,3,143,2020-02-26,43,CH032
2020-04-09,BL,Basel-Landschaft,9,1,776,21,0,143,2020-02-26,44,CH032
2020-04-10,BL,Basel-Landschaft,3,1,779,22,4,147,2020-02-26,45,CH032
2020-04-11,BL,Basel-Landschaft,9,1,788,23,0,147,2020-02-26,46,CH032
2020-04-12,BL,Basel-Landschaft,7,1,795,24,2,149,2020-02-26,47,CH032
2020-04-13,BL,Basel-Landschaft,6,0,801,24,2,151,2020-02-26,48,CH032
2020-04-14,BL,Basel-Landschaft,18,0,819,24,2,153,2020-02-26,49,CH032
2020-04-15,BL,Basel-Landschaft,11,0,830,24,3,156,2020-02-26,50,CH032
2020-04-16,BL,Basel-Landschaft,8,0,838,24,1,157,2020-02-26,51,CH032
2020-04-17,BL,Basel-Landschaft,3,0,841,24,1,158,2020-02-26,52,CH032
2020-04-18,BL,Basel-Landschaft,2,0,843,24,1,159,2020-02-26,53,CH032
2020-04-19,BL,Basel-Landschaft,1,0,844,24,1,160,2020-02-26,54,CH032
2020-04-20,BL,Basel-Landschaft,6,1,850,25,0,160,2020-02-26,55,CH032
2020-04-21,BL,Basel-Landschaft,2,1,852,26,0,160,2020-02-26,56,CH032
2020-04-22,BL,Basel-Landschaft,1,0,853,26,2,162,2020-02-26,57,CH032
2020-04-23,BL,Basel-Landschaft,3,2,856,28,0,162,2020-02-26,58,CH032
2020-04-24,BL,Basel-Landschaft,2,0,858,28,0,162,2020-02-26,59,CH032
2020-04-25,BL,Basel-Landschaft,0,0,858,28,0,162,2020-02-26,60,CH032
2020-04-26,BL,Basel-Landschaft,1,0,859,28,0,162,2020-02-26,61,CH032
2020-04-27,BL,Basel-Landschaft,3,1,862,29,0,162,2020-02-26,62,CH032
2020-04-28,BL,Basel-Landschaft,4,0,866,29,0,162,2020-02-26,63,CH032
2020-04-29,BL,Basel-Landschaft,2,0,868,29,0,162,2020-02-26,64,CH032
2020-04-30,BL,Basel-Landschaft,2,1,870,30,0,162,2020-02-26,65,CH032
2020-05-01,BL,Basel-Landschaft,2,1,872,31,0,162,2020-02-26,66,CH032
2020-05-02,BL,Basel-Landschaft,1,0,873,31,0,162,2020-02-26,67,CH032
2020-05-03,BL,Basel-Landschaft,0,0,873,31,0,162,2020-02-26,68,CH032
2020-05-04,BL,Basel-Landschaft,1,1,874,32,0,162,2020-02-26,69,CH032
2020-05-05,BL,Basel-Landschaft,0,0,874,32,0,162,2020-02-26,70,CH032
2020-05-06,BL,Basel-Landschaft,1,0,875,32,0,162,2020-02-26,71,CH032
2020-05-07,BL,Basel-Landschaft,0,1,875,33,0,162,2020-02-26,72,CH032
2020-05-08,BL,Basel-Landschaft,0,0,875,33,0,162,2020-02-26,73,CH032
2020-05-09,BL,Basel-Landschaft,1,0,876,33,0,162,2020-02-26,74,CH032
2020-05-10,BL,Basel-Landschaft,0,0,876,33,0,162,2020-02-26,75,CH032
2020-05-11,BL,Basel-Landschaft,1,0,877,33,0,162,2020-02-26,76,CH032
2020-05-12,BL,Basel-Landschaft,0,0,877,33,0,162,2020-02-26,77,CH032
2020-05-13,BL,Basel-Landschaft,0,0,877,33,0,162,2020-02-26,78,CH032
2020-05-14,BL,Basel-Landschaft,0,0,877,33,0,162,2020-02-26,79,CH032
2020-05-15,BL,Basel-Landschaft,1,1,878,34,0,162,2020-02-26,80,CH032
2020-05-16,BL,Basel-Landschaft,0,0,878,34,0,162,2020-02-26,81,CH032
2020-05-17,BL,Basel-Landschaft,0,0,878,34,0,162,2020-02-26,82,CH032
2020-05-18,BL,Basel-Landschaft,0,0,878,34,0,162,2020-02-26,83,CH032
2020-05-19,BL,Basel-Landschaft,0,0,878,34,0,162,2020-02-26,84,CH032
2020-05-20,BL,Basel-Landschaft,0,0,878,34,0,162,2020-02-26,85,CH032
2020-05-21,BL,Basel-Landschaft,0,0,878,34,0,162,2020-02-26,86,CH032
2020-05-22,BL,Basel-Landschaft,0,0,878,34,0,162,2020-02-26,87,CH032
2020-05-23,BL,Basel-Landschaft,0,0,878,34,0,162,2020-02-26,88,CH032
2020-02-24,BS,Basel-Stadt,0,0,0,0,0,0,2020-02-26,-1,CH031
2020-02-25,BS,Basel-Stadt,0,0,0,0,0,0,2020-02-26,0,CH031
2020-02-26,BS,Basel-Stadt,1,0,1,0,0,0,2020-02-26,1,CH031
2020-02-27,BS,Basel-Stadt,0,0,1,0,1,1,2020-02-26,2,CH031
2020-02-28,BS,Basel-Stadt,2,0,3,0,2,3,2020-02-26,3,CH031
2020-02-29,BS,Basel-Stadt,0,0,3,0,0,3,2020-02-26,4,CH031
2020-03-01,BS,Basel-Stadt,1,0,4,0,0,3,2020-02-26,5,CH031
2020-03-02,BS,Basel-Stadt,1,0,5,0,0,3,2020-02-26,6,CH031
2020-03-03,BS,Basel-Stadt,1,0,6,0,1,4,2020-02-26,7,CH031
2020-03-04,BS,Basel-Stadt,6,0,12,0,0,4,2020-02-26,8,CH031
2020-03-05,BS,Basel-Stadt,10,0,22,0,2,6,2020-02-26,9,CH031
2020-03-06,BS,Basel-Stadt,5,0,27,0,2,8,2020-02-26,10,CH031
2020-03-07,BS,Basel-Stadt,5,0,32,0,0,8,2020-02-26,11,CH031
2020-03-08,BS,Basel-Stadt,7,0,39,0,2,10,2020-02-26,12,CH031
2020-03-09,BS,Basel-Stadt,13,0,52,0,4,14,2020-02-26,13,CH031
2020-03-10,BS,Basel-Stadt,18,0,70,0,6,20,2020-02-26,14,CH031
2020-03-11,BS,Basel-Stadt,40,0,110,0,5,25,2020-02-26,15,CH031
2020-03-12,BS,Basel-Stadt,23,1,133,1,3,28,2020-02-26,16,CH031
2020-03-13,BS,Basel-Stadt,23,0,156,1,1,29,2020-02-26,17,CH031
2020-03-14,BS,Basel-Stadt,19,1,175,2,5,34,2020-02-26,18,CH031
2020-03-15,BS,Basel-Stadt,18,2,193,4,2,36,2020-02-26,19,CH031
2020-03-16,BS,Basel-Stadt,31,1,224,5,5,41,2020-02-26,20,CH031
2020-03-17,BS,Basel-Stadt,38,1,262,6,2,43,2020-02-26,21,CH031
2020-03-18,BS,Basel-Stadt,54,0,316,6,6,49,2020-02-26,22,CH031
2020-03-19,BS,Basel-Stadt,38,0,354,6,3,52,2020-02-26,23,CH031
2020-03-20,BS,Basel-Stadt,56,0,410,6,6,58,2020-02-26,24,CH031
2020-03-21,BS,Basel-Stadt,34,0,444,6,4,62,2020-02-26,25,CH031
2020-03-22,BS,Basel-Stadt,43,0,487,6,6,68,2020-02-26,26,CH031
2020-03-23,BS,Basel-Stadt,73,1,560,7,4,72,2020-02-26,27,CH031
2020-03-24,BS,Basel-Stadt,41,2,601,9,2,74,2020-02-26,28,CH031
2020-03-25,BS,Basel-Stadt,43,5,644,14,6,80,2020-02-26,29,CH031
2020-03-26,BS,Basel-Stadt,34,0,678,14,7,87,2020-02-26,30,CH031
2020-03-27,BS,Basel-Stadt,44,1,722,15,13,100,2020-02-26,31,CH031
2020-03-28,BS,Basel-Stadt,28,2,750,17,4,104,2020-02-26,32,CH031
2020-03-29,BS,Basel-Stadt,15,1,765,18,4,108,2020-02-26,33,CH031
2020-03-30,BS,Basel-Stadt,45,0,810,18,9,117,2020-02-26,34,CH031
2020-03-31,BS,Basel-Stadt,31,0,841,18,3,120,2020-02-26,35,CH031
2020-04-01,BS,Basel-Stadt,36,2,877,20,1,121,2020-02-26,36,CH031
2020-04-02,BS,Basel-Stadt,19,1,896,21,1,122,2020-02-26,37,CH031
2020-04-03,BS,Basel-Stadt,29,5,925,26,1,123,2020-02-26,38,CH031
2020-04-04,BS,Basel-Stadt,12,3,937,29,1,124,2020-02-26,39,CH031
2020-04-05,BS,Basel-Stadt,12,2,949,31,2,126,2020-02-26,40,CH031
2020-04-06,BS,Basel-Stadt,21,1,970,32,3,129,2020-02-26,41,CH031
2020-04-07,BS,Basel-Stadt,20,2,990,34,1,130,2020-02-26,42,CH031
2020-04-08,BS,Basel-Stadt,17,2,1007,36,3,133,2020-02-26,43,CH031
2020-04-09,BS,Basel-Stadt,9,0,1016,36,0,133,2020-02-26,44,CH031
2020-04-10,BS,Basel-Stadt,6,1,1022,37,1,134,2020-02-26,45,CH031
2020-04-11,BS,Basel-Stadt,5,0,1027,37,0,134,2020-02-26,46,CH031
2020-04-12,BS,Basel-Stadt,7,2,1034,39,1,135,2020-02-26,47,CH031
2020-04-13,BS,Basel-Stadt,11,1,1045,40,0,135,2020-02-26,48,CH031
2020-04-14,BS,Basel-Stadt,6,2,1051,42,1,136,2020-02-26,49,CH031
2020-04-15,BS,Basel-Stadt,8,1,1059,43,1,137,2020-02-26,50,CH031
2020-04-16,BS,Basel-Stadt,12,1,1071,44,0,137,2020-02-26,51,CH031
2020-04-17,BS,Basel-Stadt,3,1,1074,45,0,137,2020-02-26,52,CH031
2020-04-18,BS,Basel-Stadt,3,2,1077,47,0,137,2020-02-26,53,CH031
2020-04-19,BS,Basel-Stadt,1,0,1078,47,0,137,2020-02-26,54,CH031
2020-04-20,BS,Basel-Stadt,0,1,1078,48,1,138,2020-02-26,55,CH031
2020-04-21,BS,Basel-Stadt,5,1,1083,49,0,138,2020-02-26,56,CH031
2020-04-22,BS,Basel-Stadt,3,0,1086,49,0,138,2020-02-26,57,CH031
2020-04-23,BS,Basel-Stadt,2,1,1088,50,0,138,2020-02-26,58,CH031
2020-04-24,BS,Basel-Stadt,2,0,1090,50,0,138,2020-02-26,59,CH031
2020-04-25,BS,Basel-Stadt,1,0,1091,50,1,139,2020-02-26,60,CH031
2020-04-26,BS,Basel-Stadt,0,0,1091,50,0,139,2020-02-26,61,CH031
2020-04-27,BS,Basel-Stadt,7,2,1098,52,2,141,2020-02-26,62,CH031
2020-04-28,BS,Basel-Stadt,4,0,1102,52,1,142,2020-02-26,63,CH031
2020-04-29,BS,Basel-Stadt,1,0,1103,52,0,142,2020-02-26,64,CH031
2020-04-30,BS,Basel-Stadt,3,0,1106,52,0,142,2020-02-26,65,CH031
2020-05-01,BS,Basel-Stadt,2,0,1108,52,0,142,2020-02-26,66,CH031
2020-05-02,BS,Basel-Stadt,3,0,1111,52,0,142,2020-02-26,67,CH031
2020-05-03,BS,Basel-Stadt,0,0,1111,52,0,142,2020-02-26,68,CH031
2020-05-04,BS,Basel-Stadt,1,0,1112,52,0,142,2020-02-26,69,CH031
2020-05-05,BS,Basel-Stadt,2,0,1114,52,1,143,2020-02-26,70,CH031
2020-05-06,BS,Basel-Stadt,1,0,1115,52,0,143,2020-02-26,71,CH031
2020-05-07,BS,Basel-Stadt,1,0,1116,52,0,143,2020-02-26,72,CH031
2020-05-08,BS,Basel-Stadt,0,0,1116,52,0,143,2020-02-26,73,CH031
2020-05-09,BS,Basel-Stadt,1,0,1117,52,0,143,2020-02-26,74,CH031
2020-05-10,BS,Basel-Stadt,1,0,1118,52,0,143,2020-02-26,75,CH031
2020-05-11,BS,Basel-Stadt,0,0,1118,52,0,143,2020-02-26,76,CH031
2020-05-12,BS,Basel-Stadt,0,0,1118,52,0,143,2020-02-26,77,CH031
2020-05-13,BS,Basel-Stadt,3,0,1121,52,1,144,2020-02-26,78,CH031
2020-05-14,BS,Basel-Stadt,1,0,1122,52,0,144,2020-02-26,79,CH031
2020-05-15,BS,Basel-Stadt,1,0,1123,52,0,144,2020-02-26,80,CH031
2020-05-16,BS,Basel-Stadt,0,0,1123,52,0,144,2020-02-26,81,CH031
2020-05-17,BS,Basel-Stadt,1,0,1124,52,1,145,2020-02-26,82,CH031
2020-05-18,BS,Basel-Stadt,0,0,1124,52,0,145,2020-02-26,83,CH031
2020-05-19,BS,Basel-Stadt,1,0,1125,52,0,145,2020-02-26,84,CH031
2020-05-20,BS,Basel-Stadt,0,0,1125,52,0,145,2020-02-26,85,CH031
2020-05-21,BS,Basel-Stadt,0,0,1125,52,0,145,2020-02-26,86,CH031
2020-05-22,BS,Basel-Stadt,0,0,1125,52,0,145,2020-02-26,87,CH031
2020-05-23,BS,Basel-Stadt,0,0,1125,52,0,145,2020-02-26,88,CH031
2020-02-24,FR,Freiburg,0,0,0,0,0,0,2020-02-29,-4,CH022
2020-02-25,FR,Freiburg,0,0,0,0,0,0,2020-02-29,-3,CH022
2020-02-26,FR,Freiburg,0,0,0,0,1,1,2020-02-29,-2,CH022
2020-02-27,FR,Freiburg,0,0,0,0,0,1,2020-02-29,-1,CH022
2020-02-28,FR,Freiburg,0,0,0,0,0,1,2020-02-29,0,CH022
2020-02-29,FR,Freiburg,2,0,2,0,1,2,2020-02-29,1,CH022
2020-03-01,FR,Freiburg,0,0,2,0,1,3,2020-02-29,2,CH022
2020-03-02,FR,Freiburg,0,0,2,0,3,6,2020-02-29,3,CH022
2020-03-03,FR,Freiburg,3,0,5,0,0,6,2020-02-29,4,CH022
2020-03-04,FR,Freiburg,2,0,7,0,0,6,2020-02-29,5,CH022
2020-03-05,FR,Freiburg,1,0,8,0,2,8,2020-02-29,6,CH022
2020-03-06,FR,Freiburg,1,0,9,0,1,9,2020-02-29,7,CH022
2020-03-07,FR,Freiburg,0,0,9,0,0,9,2020-02-29,8,CH022
2020-03-08,FR,Freiburg,4,0,13,0,1,10,2020-02-29,9,CH022
2020-03-09,FR,Freiburg,3,0,16,0,1,11,2020-02-29,10,CH022
2020-03-10,FR,Freiburg,10,0,26,0,2,13,2020-02-29,11,CH022
2020-03-11,FR,Freiburg,8,0,34,0,0,13,2020-02-29,12,CH022
2020-03-12,FR,Freiburg,6,0,40,0,3,16,2020-02-29,13,CH022
2020-03-13,FR,Freiburg,4,0,44,0,2,18,2020-02-29,14,CH022
2020-03-14,FR,Freiburg,9,0,53,0,1,19,2020-02-29,15,CH022
2020-03-15,FR,Freiburg,4,0,57,0,2,21,2020-02-29,16,CH022
2020-03-16,FR,Freiburg,24,0,81,0,7,28,2020-02-29,17,CH022
2020-03-17,FR,Freiburg,28,1,109,1,3,31,2020-02-29,18,CH022
2020-03-18,FR,Freiburg,26,1,135,2,5,36,2020-02-29,19,CH022
2020-03-19,FR,Freiburg,18,0,153,2,6,42,2020-02-29,20,CH022
2020-03-20,FR,Freiburg,35,2,188,4,9,51,2020-02-29,21,CH022
2020-03-21,FR,Freiburg,18,2,206,6,5,56,2020-02-29,22,CH022
2020-03-22,FR,Freiburg,23,0,229,6,3,59,2020-02-29,23,CH022
2020-03-23,FR,Freiburg,41,1,270,7,9,68,2020-02-29,24,CH022
2020-03-24,FR,Freiburg,36,1,306,8,14,82,2020-02-29,25,CH022
2020-03-25,FR,Freiburg,39,2,345,10,8,90,2020-02-29,26,CH022
2020-03-26,FR,Freiburg,37,2,382,12,19,109,2020-02-29,27,CH022
2020-03-27,FR,Freiburg,47,1,429,13,13,122,2020-02-29,28,CH022
2020-03-28,FR,Freiburg,28,2,457,15,5,127,2020-02-29,29,CH022
2020-03-29,FR,Freiburg,13,3,470,18,7,134,2020-02-29,30,CH022
2020-03-30,FR,Freiburg,33,4,503,22,14,148,2020-02-29,31,CH022
2020-03-31,FR,Freiburg,56,3,559,25,5,153,2020-02-29,32,CH022
2020-04-01,FR,Freiburg,34,5,593,30,9,162,2020-02-29,33,CH022
2020-04-02,FR,Freiburg,34,3,627,33,6,168,2020-02-29,34,CH022
2020-04-03,FR,Freiburg,42,5,669,38,4,172,2020-02-29,35,CH022
2020-04-04,FR,Freiburg,41,2,710,40,5,177,2020-02-29,36,CH022
2020-04-05,FR,Freiburg,17,0,727,40,1,178,2020-02-29,37,CH022
2020-04-06,FR,Freiburg,39,3,766,43,2,180,2020-02-29,38,CH022
2020-04-07,FR,Freiburg,28,2,794,45,3,183,2020-02-29,39,CH022
2020-04-08,FR,Freiburg,23,2,817,47,4,187,2020-02-29,40,CH022
2020-04-09,FR,Freiburg,29,4,846,51,4,191,2020-02-29,41,CH022
2020-04-10,FR,Freiburg,16,4,862,55,3,194,2020-02-29,42,CH022
2020-04-11,FR,Freiburg,18,1,880,56,0,194,2020-02-29,43,CH022
2020-04-12,FR,Freiburg,14,0,894,56,3,197,2020-02-29,44,CH022
2020-04-13,FR,Freiburg,11,4,905,60,2,199,2020-02-29,45,CH022
2020-04-14,FR,Freiburg,18,3,923,63,6,205,2020-02-29,46,CH022
2020-04-15,FR,Freiburg,21,2,944,65,5,210,2020-02-29,47,CH022
2020-04-16,FR,Freiburg,28,3,972,68,5,215,2020-02-29,48,CH022
2020-04-17,FR,Freiburg,18,3,990,71,2,217,2020-02-29,49,CH022
2020-04-18,FR,Freiburg,10,1,1000,72,2,219,2020-02-29,50,CH022
2020-04-19,FR,Freiburg,3,1,1003,73,2,221,2020-02-29,51,CH022
2020-04-20,FR,Freiburg,12,3,1015,76,3,224,2020-02-29,52,CH022
2020-04-21,FR,Freiburg,9,1,1024,77,1,225,2020-02-29,53,CH022
2020-04-22,FR,Freiburg,5,0,1029,77,3,228,2020-02-29,54,CH022
2020-04-23,FR,Freiburg,7,0,1036,77,0,228,2020-02-29,55,CH022
2020-04-24,FR,Freiburg,6,0,1042,77,0,228,2020-02-29,56,CH022
2020-04-25,FR,Freiburg,7,1,1049,78,0,228,2020-02-29,57,CH022
2020-04-26,FR,Freiburg,1,0,1050,78,0,228,2020-02-29,58,CH022
2020-04-27,FR,Freiburg,15,1,1065,79,1,229,2020-02-29,59,CH022
2020-04-28,FR,Freiburg,8,0,1073,79,2,231,2020-02-29,60,CH022
2020-04-29,FR,Freiburg,9,0,1082,79,1,232,2020-02-29,61,CH022
2020-04-30,FR,Freiburg,11,0,1093,79,0,232,2020-02-29,62,CH022
2020-05-01,FR,Freiburg,7,1,1100,80,0,232,2020-02-29,63,CH022
2020-05-02,FR,Freiburg,6,0,1106,80,0,232,2020-02-29,64,CH022
2020-05-03,FR,Freiburg,2,0,1108,80,1,233,2020-02-29,65,CH022
2020-05-04,FR,Freiburg,4,1,1112,81,0,233,2020-02-29,66,CH022
2020-05-05,FR,Freiburg,4,0,1116,81,0,233,2020-02-29,67,CH022
2020-05-06,FR,Freiburg,3,0,1119,81,0,233,2020-02-29,68,CH022
2020-05-07,FR,Freiburg,4,2,1123,83,0,233,2020-02-29,69,CH022
2020-05-08,FR,Freiburg,6,0,1129,83,0,233,2020-02-29,70,CH022
2020-05-09,FR,Freiburg,7,1,1136,84,0,233,2020-02-29,71,CH022
2020-05-10,FR,Freiburg,2,0,1138,84,0,233,2020-02-29,72,CH022
2020-05-11,FR,Freiburg,5,1,1143,85,2,235,2020-02-29,73,CH022
2020-05-12,FR,Freiburg,1,0,1144,85,0,235,2020-02-29,74,CH022
2020-05-13,FR,Freiburg,1,0,1145,85,1,236,2020-02-29,75,CH022
2020-05-14,FR,Freiburg,1,0,1146,85,0,236,2020-02-29,76,CH022
2020-05-15,FR,Freiburg,1,0,1147,85,1,237,2020-02-29,77,CH022
2020-05-16,FR,Freiburg,0,0,1147,85,0,237,2020-02-29,78,CH022
2020-05-17,FR,Freiburg,0,0,1147,85,0,237,2020-02-29,79,CH022
2020-05-18,FR,Freiburg,3,0,1150,85,0,237,2020-02-29,80,CH022
2020-05-19,FR,Freiburg,2,0,1152,85,1,238,2020-02-29,81,CH022
2020-05-20,FR,Freiburg,1,0,1153,85,1,239,2020-02-29,82,CH022
2020-05-21,FR,Freiburg,0,0,1153,85,0,239,2020-02-29,83,CH022
2020-05-22,FR,Freiburg,0,0,1153,85,0,239,2020-02-29,84,CH022
2020-05-23,FR,Freiburg,0,0,1153,85,0,239,2020-02-29,85,CH022
2020-02-24,GE,Genf,0,0,0,0,1,1,2020-02-26,-1,CH013
2020-02-25,GE,Genf,0,0,0,0,0,1,2020-02-26,0,CH013
2020-02-26,GE,Genf,1,0,1,0,1,2,2020-02-26,1,CH013
2020-02-27,GE,Genf,3,0,4,0,0,2,2020-02-26,2,CH013
2020-02-28,GE,Genf,5,0,9,0,0,2,2020-02-26,3,CH013
2020-02-29,GE,Genf,0,0,9,0,0,2,2020-02-26,4,CH013
2020-03-01,GE,Genf,1,0,10,0,1,3,2020-02-26,5,CH013
2020-03-02,GE,Genf,2,0,12,0,1,4,2020-02-26,6,CH013
2020-03-03,GE,Genf,0,0,12,0,0,4,2020-02-26,7,CH013
2020-03-04,GE,Genf,1,0,13,0,2,6,2020-02-26,8,CH013
2020-03-05,GE,Genf,4,0,17,0,2,8,2020-02-26,9,CH013
2020-03-06,GE,Genf,17,0,34,0,1,9,2020-02-26,10,CH013
2020-03-07,GE,Genf,6,0,40,0,1,10,2020-02-26,11,CH013
2020-03-08,GE,Genf,9,0,49,0,1,11,2020-02-26,12,CH013
2020-03-09,GE,Genf,29,0,78,0,5,16,2020-02-26,13,CH013
2020-03-10,GE,Genf,18,1,96,1,6,22,2020-02-26,14,CH013
2020-03-11,GE,Genf,33,0,129,1,3,25,2020-02-26,15,CH013
2020-03-12,GE,Genf,49,1,178,2,3,28,2020-02-26,16,CH013
2020-03-13,GE,Genf,72,0,250,2,7,35,2020-02-26,17,CH013
2020-03-14,GE,Genf,67,0,317,2,4,39,2020-02-26,18,CH013
2020-03-15,GE,Genf,30,2,347,4,6,45,2020-02-26,19,CH013
2020-03-16,GE,Genf,124,0,471,4,10,55,2020-02-26,20,CH013
2020-03-17,GE,Genf,168,1,639,5,14,69,2020-02-26,21,CH013
2020-03-18,GE,Genf,142,1,781,6,15,84,2020-02-26,22,CH013
2020-03-19,GE,Genf,61,1,842,7,13,97,2020-02-26,23,CH013
2020-03-20,GE,Genf,59,2,901,9,7,104,2020-02-26,24,CH013
2020-03-21,GE,Genf,149,0,1050,9,12,116,2020-02-26,25,CH013
2020-03-22,GE,Genf,87,1,1137,10,12,128,2020-02-26,26,CH013
2020-03-23,GE,Genf,174,4,1311,14,19,147,2020-02-26,27,CH013
2020-03-24,GE,Genf,139,1,1450,15,15,162,2020-02-26,28,CH013
2020-03-25,GE,Genf,142,7,1592,22,12,174,2020-02-26,29,CH013
2020-03-26,GE,Genf,205,2,1797,24,11,185,2020-02-26,30,CH013
2020-03-27,GE,Genf,180,7,1977,31,18,203,2020-02-26,31,CH013
2020-03-28,GE,Genf,219,7,2196,38,19,222,2020-02-26,32,CH013
2020-03-29,GE,Genf,103,9,2299,47,21,243,2020-02-26,33,CH013
2020-03-30,GE,Genf,244,8,2543,55,23,266,2020-02-26,34,CH013
2020-03-31,GE,Genf,281,10,2824,65,13,279,2020-02-26,35,CH013
2020-04-01,GE,Genf,276,9,3100,74,9,288,2020-02-26,36,CH013
2020-04-02,GE,Genf,249,8,3349,82,11,299,2020-02-26,37,CH013
2020-04-03,GE,Genf,196,6,3545,88,1,300,2020-02-26,38,CH013
2020-04-04,GE,Genf,120,13,3665,101,8,308,2020-02-26,39,CH013
2020-04-05,GE,Genf,73,7,3738,108,4,312,2020-02-26,40,CH013
2020-04-06,GE,Genf,189,12,3927,120,8,320,2020-02-26,41,CH013
2020-04-07,GE,Genf,173,11,4100,131,8,328,2020-02-26,42,CH013
2020-04-08,GE,Genf,130,14,4230,145,5,333,2020-02-26,43,CH013
2020-04-09,GE,Genf,111,8,4341,153,5,338,2020-02-26,44,CH013
2020-04-10,GE,Genf,51,12,4392,165,1,339,2020-02-26,45,CH013
2020-04-11,GE,Genf,53,8,4445,173,3,342,2020-02-26,46,CH013
2020-04-12,GE,Genf,34,8,4479,181,4,346,2020-02-26,47,CH013
2020-04-13,GE,Genf,54,3,4533,184,2,348,2020-02-26,48,CH013
2020-04-14,GE,Genf,79,5,4612,189,3,351,2020-02-26,49,CH013
2020-04-15,GE,Genf,68,6,4680,195,3,354,2020-02-26,50,CH013
2020-04-16,GE,Genf,63,7,4743,202,3,357,2020-02-26,51,CH013
2020-04-17,GE,Genf,64,6,4807,208,1,358,2020-02-26,52,CH013
2020-04-18,GE,Genf,32,4,4839,212,0,358,2020-02-26,53,CH013
2020-04-19,GE,Genf,16,3,4855,215,3,361,2020-02-26,54,CH013
2020-04-20,GE,Genf,39,3,4894,218,0,361,2020-02-26,55,CH013
2020-04-21,GE,Genf,29,5,4923,223,1,362,2020-02-26,56,CH013
2020-04-22,GE,Genf,26,8,4949,231,0,362,2020-02-26,57,CH013
2020-04-23,GE,Genf,37,2,4986,233,1,363,2020-02-26,58,CH013
2020-04-24,GE,Genf,21,5,5007,238,0,363,2020-02-26,59,CH013
2020-04-25,GE,Genf,11,1,5018,239,0,363,2020-02-26,60,CH013
2020-04-26,GE,Genf,10,1,5028,240,0,363,2020-02-26,61,CH013
2020-04-27,GE,Genf,20,1,5048,241,1,364,2020-02-26,62,CH013
2020-04-28,GE,Genf,19,1,5067,242,0,364,2020-02-26,63,CH013
2020-04-29,GE,Genf,16,1,5083,243,0,364,2020-02-26,64,CH013
2020-04-30,GE,Genf,13,3,5096,246,0,364,2020-02-26,65,CH013
2020-05-01,GE,Genf,18,2,5114,248,0,364,2020-02-26,66,CH013
2020-05-02,GE,Genf,5,3,5119,251,1,365,2020-02-26,67,CH013
2020-05-03,GE,Genf,4,0,5123,251,0,365,2020-02-26,68,CH013
2020-05-04,GE,Genf,11,1,5134,252,0,365,2020-02-26,69,CH013
2020-05-05,GE,Genf,12,1,5146,253,0,365,2020-02-26,70,CH013
2020-05-06,GE,Genf,7,1,5153,254,0,365,2020-02-26,71,CH013
2020-05-07,GE,Genf,2,4,5155,258,1,366,2020-02-26,72,CH013
2020-05-08,GE,Genf,2,0,5157,258,0,366,2020-02-26,73,CH013
2020-05-09,GE,Genf,3,1,5160,259,0,366,2020-02-26,74,CH013
2020-05-10,GE,Genf,1,2,5161,261,1,367,2020-02-26,75,CH013
2020-05-11,GE,Genf,5,0,5166,261,0,367,2020-02-26,76,CH013
2020-05-12,GE,Genf,5,1,5171,262,0,367,2020-02-26,77,CH013
2020-05-13,GE,Genf,2,0,5173,262,0,367,2020-02-26,78,CH013
2020-05-14,GE,Genf,9,0,5182,262,2,369,2020-02-26,79,CH013
2020-05-15,GE,Genf,4,0,5186,262,0,369,2020-02-26,80,CH013
2020-05-16,GE,Genf,1,0,5187,262,0,369,2020-02-26,81,CH013
2020-05-17,GE,Genf,1,1,5188,263,0,369,2020-02-26,82,CH013
2020-05-18,GE,Genf,2,1,5190,264,1,370,2020-02-26,83,CH013
2020-05-19,GE,Genf,3,0,5193,264,0,370,2020-02-26,84,CH013
2020-05-20,GE,Genf,0,0,5193,264,0,370,2020-02-26,85,CH013
2020-05-21,GE,Genf,0,0,5193,264,0,370,2020-02-26,86,CH013
2020-05-22,GE,Genf,0,0,5193,264,0,370,2020-02-26,87,CH013
2020-05-23,GE,Genf,0,0,5193,264,0,370,2020-02-26,88,CH013
2020-02-24,GL,Glarus,0,0,0,0,0,0,2020-03-09,-13,CH051
2020-02-25,GL,Glarus,0,0,0,0,0,0,2020-03-09,-12,CH051
2020-02-26,GL,Glarus,0,0,0,0,0,0,2020-03-09,-11,CH051
2020-02-27,GL,Glarus,0,0,0,0,0,0,2020-03-09,-10,CH051
2020-02-28,GL,Glarus,0,0,0,0,0,0,2020-03-09,-9,CH051
2020-02-29,GL,Glarus,0,0,0,0,0,0,2020-03-09,-8,CH051
2020-03-01,GL,Glarus,0,0,0,0,0,0,2020-03-09,-7,CH051
2020-03-02,GL,Glarus,0,0,0,0,0,0,2020-03-09,-6,CH051
2020-03-03,GL,Glarus,0,0,0,0,0,0,2020-03-09,-5,CH051
2020-03-04,GL,Glarus,0,0,0,0,0,0,2020-03-09,-4,CH051
2020-03-05,GL,Glarus,0,0,0,0,0,0,2020-03-09,-3,CH051
2020-03-06,GL,Glarus,0,0,0,0,0,0,2020-03-09,-2,CH051
2020-03-07,GL,Glarus,0,0,0,0,0,0,2020-03-09,-1,CH051
2020-03-08,GL,Glarus,0,0,0,0,0,0,2020-03-09,0,CH051
2020-03-09,GL,Glarus,1,0,1,0,0,0,2020-03-09,1,CH051
2020-03-10,GL,Glarus,1,0,2,0,0,0,2020-03-09,2,CH051
2020-03-11,GL,Glarus,2,0,4,0,0,0,2020-03-09,3,CH051
2020-03-12,GL,Glarus,1,0,5,0,0,0,2020-03-09,4,CH051
2020-03-13,GL,Glarus,1,0,6,0,1,1,2020-03-09,5,CH051
2020-03-14,GL,Glarus,4,0,10,0,1,2,2020-03-09,6,CH051
2020-03-15,GL,Glarus,0,0,10,0,1,3,2020-03-09,7,CH051
2020-03-16,GL,Glarus,5,0,15,0,0,3,2020-03-09,8,CH051
2020-03-17,GL,Glarus,4,0,19,0,0,3,2020-03-09,9,CH051
2020-03-18,GL,Glarus,3,0,22,0,0,3,2020-03-09,10,CH051
2020-03-19,GL,Glarus,3,0,25,0,0,3,2020-03-09,11,CH051
2020-03-20,GL,Glarus,4,0,29,0,0,3,2020-03-09,12,CH051
2020-03-21,GL,Glarus,1,0,30,0,0,3,2020-03-09,13,CH051
2020-03-22,GL,Glarus,1,0,31,0,0,3,2020-03-09,14,CH051
2020-03-23,GL,Glarus,8,0,39,0,1,4,2020-03-09,15,CH051
2020-03-24,GL,Glarus,1,0,40,0,1,5,2020-03-09,16,CH051
2020-03-25,GL,Glarus,4,0,44,0,1,6,2020-03-09,17,CH051
2020-03-26,GL,Glarus,2,0,46,0,0,6,2020-03-09,18,CH051
2020-03-27,GL,Glarus,4,0,50,0,1,7,2020-03-09,19,CH051
2020-03-28,GL,Glarus,2,1,52,1,0,7,2020-03-09,20,CH051
2020-03-29,GL,Glarus,0,0,52,1,1,8,2020-03-09,21,CH051
2020-03-30,GL,Glarus,4,1,56,2,1,9,2020-03-09,22,CH051
2020-03-31,GL,Glarus,1,0,57,2,0,9,2020-03-09,23,CH051
2020-04-01,GL,Glarus,1,0,58,2,1,10,2020-03-09,24,CH051
2020-04-02,GL,Glarus,2,0,60,2,1,11,2020-03-09,25,CH051
2020-04-03,GL,Glarus,2,0,62,2,0,11,2020-03-09,26,CH051
2020-04-04,GL,Glarus,0,0,62,2,0,11,2020-03-09,27,CH051
2020-04-05,GL,Glarus,0,0,62,2,0,11,2020-03-09,28,CH051
2020-04-06,GL,Glarus,3,0,65,2,0,11,2020-03-09,29,CH051
2020-04-07,GL,Glarus,3,0,68,2,1,12,2020-03-09,30,CH051
2020-04-08,GL,Glarus,6,0,74,2,0,12,2020-03-09,31,CH051
2020-04-09,GL,Glarus,15,0,89,2,0,12,2020-03-09,32,CH051
2020-04-10,GL,Glarus,1,0,90,2,0,12,2020-03-09,33,CH051
2020-04-11,GL,Glarus,0,0,90,2,0,12,2020-03-09,34,CH051
2020-04-12,GL,Glarus,13,0,103,2,0,12,2020-03-09,35,CH051
2020-04-13,GL,Glarus,1,0,104,2,0,12,2020-03-09,36,CH051
2020-04-14,GL,Glarus,2,0,106,2,0,12,2020-03-09,37,CH051
2020-04-15,GL,Glarus,1,0,107,2,2,14,2020-03-09,38,CH051
2020-04-16,GL,Glarus,3,1,110,3,0,14,2020-03-09,39,CH051
2020-04-17,GL,Glarus,1,0,111,3,0,14,2020-03-09,40,CH051
2020-04-18,GL,Glarus,2,2,113,5,1,15,2020-03-09,41,CH051
2020-04-19,GL,Glarus,1,1,114,6,1,16,2020-03-09,42,CH051
2020-04-20,GL,Glarus,2,0,116,6,0,16,2020-03-09,43,CH051
2020-04-21,GL,Glarus,0,1,116,7,0,16,2020-03-09,44,CH051
2020-04-22,GL,Glarus,0,0,116,7,0,16,2020-03-09,45,CH051
2020-04-23,GL,Glarus,1,0,117,7,0,16,2020-03-09,46,CH051
2020-04-24,GL,Glarus,3,1,120,8,0,16,2020-03-09,47,CH051
2020-04-25,GL,Glarus,0,0,120,8,0,16,2020-03-09,48,CH051
2020-04-26,GL,Glarus,0,0,120,8,0,16,2020-03-09,49,CH051
2020-04-27,GL,Glarus,1,1,121,9,0,16,2020-03-09,50,CH051
2020-04-28,GL,Glarus,0,0,121,9,0,16,2020-03-09,51,CH051
2020-04-29,GL,Glarus,1,2,122,11,0,16,2020-03-09,52,CH051
2020-04-30,GL,Glarus,0,0,122,11,0,16,2020-03-09,53,CH051
2020-05-01,GL,Glarus,0,0,122,11,0,16,2020-03-09,54,CH051
2020-05-02,GL,Glarus,0,1,122,12,0,16,2020-03-09,55,CH051
2020-05-03,GL,Glarus,1,0,123,12,0,16,2020-03-09,56,CH051
2020-05-04,GL,Glarus,2,0,125,12,0,16,2020-03-09,57,CH051
2020-05-05,GL,Glarus,0,0,125,12,0,16,2020-03-09,58,CH051
2020-05-06,GL,Glarus,0,0,125,12,0,16,2020-03-09,59,CH051
2020-05-07,GL,Glarus,1,0,126,12,0,16,2020-03-09,60,CH051
2020-05-08,GL,Glarus,1,0,127,12,0,16,2020-03-09,61,CH051
2020-05-09,GL,Glarus,0,0,127,12,0,16,2020-03-09,62,CH051
2020-05-10,GL,Glarus,0,0,127,12,0,16,2020-03-09,63,CH051
2020-05-11,GL,Glarus,0,0,127,12,0,16,2020-03-09,64,CH051
2020-05-12,GL,Glarus,0,0,127,12,0,16,2020-03-09,65,CH051
2020-05-13,GL,Glarus,0,0,127,12,0,16,2020-03-09,66,CH051
2020-05-14,GL,Glarus,0,0,127,12,0,16,2020-03-09,67,CH051
2020-05-15,GL,Glarus,0,0,127,12,0,16,2020-03-09,68,CH051
2020-05-16,GL,Glarus,0,0,127,12,0,16,2020-03-09,69,CH051
2020-05-17,GL,Glarus,0,0,127,12,0,16,2020-03-09,70,CH051
2020-05-18,GL,Glarus,0,0,127,12,0,16,2020-03-09,71,CH051
2020-05-19,GL,Glarus,0,0,127,12,0,16,2020-03-09,72,CH051
2020-05-20,GL,Glarus,0,0,127,12,0,16,2020-03-09,73,CH051
2020-05-21,GL,Glarus,0,0,127,12,0,16,2020-03-09,74,CH051
2020-05-22,GL,Glarus,0,0,127,12,0,16,2020-03-09,75,CH051
2020-05-23,GL,Glarus,0,0,127,12,0,16,2020-03-09,76,CH051
2020-02-24,GR,Graubünden,0,0,0,0,0,0,2020-02-26,-1,CH056
2020-02-25,GR,Graubünden,0,0,0,0,0,0,2020-02-26,0,CH056
2020-02-26,GR,Graubünden,4,0,4,0,4,4,2020-02-26,1,CH056
2020-02-27,GR,Graubünden,2,0,6,0,1,5,2020-02-26,2,CH056
2020-02-28,GR,Graubünden,0,0,6,0,0,5,2020-02-26,3,CH056
2020-02-29,GR,Graubünden,2,0,8,0,0,5,2020-02-26,4,CH056
2020-03-01,GR,Graubünden,1,0,9,0,0,5,2020-02-26,5,CH056
2020-03-02,GR,Graubünden,0,0,9,0,0,5,2020-02-26,6,CH056
2020-03-03,GR,Graubünden,1,0,10,0,1,6,2020-02-26,7,CH056
2020-03-04,GR,Graubünden,2,0,12,0,1,7,2020-02-26,8,CH056
2020-03-05,GR,Graubünden,3,0,15,0,1,8,2020-02-26,9,CH056
2020-03-06,GR,Graubünden,0,0,15,0,0,8,2020-02-26,10,CH056
2020-03-07,GR,Graubünden,1,0,16,0,1,9,2020-02-26,11,CH056
2020-03-08,GR,Graubünden,1,0,17,0,0,9,2020-02-26,12,CH056
2020-03-09,GR,Graubünden,11,0,28,0,0,9,2020-02-26,13,CH056
2020-03-10,GR,Graubünden,4,0,32,0,0,9,2020-02-26,14,CH056
2020-03-11,GR,Graubünden,12,0,44,0,1,10,2020-02-26,15,CH056
2020-03-12,GR,Graubünden,8,0,52,0,1,11,2020-02-26,16,CH056
2020-03-13,GR,Graubünden,14,0,66,0,3,14,2020-02-26,17,CH056
2020-03-14,GR,Graubünden,11,0,77,0,2,16,2020-02-26,18,CH056
2020-03-15,GR,Graubünden,18,0,95,0,3,19,2020-02-26,19,CH056
2020-03-16,GR,Graubünden,25,1,120,1,2,21,2020-02-26,20,CH056
2020-03-17,GR,Graubünden,35,0,155,1,2,23,2020-02-26,21,CH056
2020-03-18,GR,Graubünden,51,0,206,1,4,27,2020-02-26,22,CH056
2020-03-19,GR,Graubünden,43,1,249,2,1,28,2020-02-26,23,CH056
2020-03-20,GR,Graubünden,26,2,275,4,5,33,2020-02-26,24,CH056
2020-03-21,GR,Graubünden,27,1,302,5,3,36,2020-02-26,25,CH056
2020-03-22,GR,Graubünden,14,0,316,5,2,38,2020-02-26,26,CH056
2020-03-23,GR,Graubünden,60,1,376,6,7,45,2020-02-26,27,CH056
2020-03-24,GR,Graubünden,33,1,409,7,4,49,2020-02-26,28,CH056
2020-03-25,GR,Graubünden,37,1,446,8,8,57,2020-02-26,29,CH056
2020-03-26,GR,Graubünden,28,0,474,8,6,63,2020-02-26,30,CH056
2020-03-27,GR,Graubünden,26,1,500,9,4,67,2020-02-26,31,CH056
2020-03-28,GR,Graubünden,14,3,514,12,1,68,2020-02-26,32,CH056
2020-03-29,GR,Graubünden,8,2,522,14,2,70,2020-02-26,33,CH056
2020-03-30,GR,Graubünden,47,4,569,18,3,73,2020-02-26,34,CH056
2020-03-31,GR,Graubünden,27,4,596,22,3,76,2020-02-26,35,CH056
2020-04-01,GR,Graubünden,21,2,617,24,3,79,2020-02-26,36,CH056
2020-04-02,GR,Graubünden,18,2,635,26,2,81,2020-02-26,37,CH056
2020-04-03,GR,Graubünden,18,2,653,28,1,82,2020-02-26,38,CH056
2020-04-04,GR,Graubünden,2,0,655,28,0,82,2020-02-26,39,CH056
2020-04-05,GR,Graubünden,3,3,658,31,0,82,2020-02-26,40,CH056
2020-04-06,GR,Graubünden,20,1,678,32,1,83,2020-02-26,41,CH056
2020-04-07,GR,Graubünden,15,1,693,33,1,84,2020-02-26,42,CH056
2020-04-08,GR,Graubünden,19,0,712,33,1,85,2020-02-26,43,CH056
2020-04-09,GR,Graubünden,5,0,717,33,2,87,2020-02-26,44,CH056
2020-04-10,GR,Graubünden,7,0,724,33,1,88,2020-02-26,45,CH056
2020-04-11,GR,Graubünden,3,0,727,33,2,90,2020-02-26,46,CH056
2020-04-12,GR,Graubünden,0,0,727,33,1,91,2020-02-26,47,CH056
2020-04-13,GR,Graubünden,3,1,730,34,0,91,2020-02-26,48,CH056
2020-04-14,GR,Graubünden,7,0,737,34,2,93,2020-02-26,49,CH056
2020-04-15,GR,Graubünden,7,1,744,35,1,94,2020-02-26,50,CH056
2020-04-16,GR,Graubünden,6,1,750,36,1,95,2020-02-26,51,CH056
2020-04-17,GR,Graubünden,2,1,752,37,0,95,2020-02-26,52,CH056
2020-04-18,GR,Graubünden,6,0,758,37,1,96,2020-02-26,53,CH056
2020-04-19,GR,Graubünden,3,1,761,38,1,97,2020-02-26,54,CH056
2020-04-20,GR,Graubünden,7,1,768,39,1,98,2020-02-26,55,CH056
2020-04-21,GR,Graubünden,3,1,771,40,1,99,2020-02-26,56,CH056
2020-04-22,GR,Graubünden,1,0,772,40,0,99,2020-02-26,57,CH056
2020-04-23,GR,Graubünden,4,0,776,40,0,99,2020-02-26,58,CH056
2020-04-24,GR,Graubünden,1,0,777,40,0,99,2020-02-26,59,CH056
2020-04-25,GR,Graubünden,3,0,780,40,1,100,2020-02-26,60,CH056
2020-04-26,GR,Graubünden,1,0,781,40,0,100,2020-02-26,61,CH056
2020-04-27,GR,Graubünden,2,1,783,41,0,100,2020-02-26,62,CH056
2020-04-28,GR,Graubünden,3,0,786,41,0,100,2020-02-26,63,CH056
2020-04-29,GR,Graubünden,0,0,786,41,0,100,2020-02-26,64,CH056
2020-04-30,GR,Graubünden,1,0,787,41,0,100,2020-02-26,65,CH056
2020-05-01,GR,Graubünden,1,0,788,41,0,100,2020-02-26,66,CH056
2020-05-02,GR,Graubünden,0,0,788,41,0,100,2020-02-26,67,CH056
2020-05-03,GR,Graubünden,0,0,788,41,0,100,2020-02-26,68,CH056
2020-05-04,GR,Graubünden,1,0,789,41,0,100,2020-02-26,69,CH056
2020-05-05,GR,Graubünden,0,0,789,41,0,100,2020-02-26,70,CH056
2020-05-06,GR,Graubünden,2,0,791,41,0,100,2020-02-26,71,CH056
2020-05-07,GR,Graubünden,1,1,792,42,0,100,2020-02-26,72,CH056
2020-05-08,GR,Graubünden,0,0,792,42,0,100,2020-02-26,73,CH056
2020-05-09,GR,Graubünden,0,0,792,42,0,100,2020-02-26,74,CH056
2020-05-10,GR,Graubünden,0,0,792,42,0,100,2020-02-26,75,CH056
2020-05-11,GR,Graubünden,1,0,793,42,0,100,2020-02-26,76,CH056
2020-05-12,GR,Graubünden,1,0,794,42,0,100,2020-02-26,77,CH056
2020-05-13,GR,Graubünden,0,0,794,42,0,100,2020-02-26,78,CH056
2020-05-14,GR,Graubünden,0,1,794,43,0,100,2020-02-26,79,CH056
2020-05-15,GR,Graubünden,0,0,794,43,0,100,2020-02-26,80,CH056
2020-05-16,GR,Graubünden,0,0,794,43,0,100,2020-02-26,81,CH056
2020-05-17,GR,Graubünden,0,1,794,44,0,100,2020-02-26,82,CH056
2020-05-18,GR,Graubünden,1,0,795,44,0,100,2020-02-26,83,CH056
2020-05-19,GR,Graubünden,0,0,795,44,0,100,2020-02-26,84,CH056
2020-05-20,GR,Graubünden,0,0,795,44,1,101,2020-02-26,85,CH056
2020-05-21,GR,Graubünden,0,0,795,44,0,101,2020-02-26,86,CH056
2020-05-22,GR,Graubünden,0,0,795,44,0,101,2020-02-26,87,CH056
2020-05-23,GR,Graubünden,0,0,795,44,0,101,2020-02-26,88,CH056
2020-02-24,JU,Jura,0,0,0,0,0,0,2020-02-26,-1,CH025
2020-02-25,JU,Jura,0,0,0,0,0,0,2020-02-26,0,CH025
2020-02-26,JU,Jura,1,0,1,0,0,0,2020-02-26,1,CH025
2020-02-27,JU,Jura,0,0,1,0,0,0,2020-02-26,2,CH025
2020-02-28,JU,Jura,0,0,1,0,0,0,2020-02-26,3,CH025
2020-02-29,JU,Jura,0,0,1,0,0,0,2020-02-26,4,CH025
2020-03-01,JU,Jura,0,0,1,0,0,0,2020-02-26,5,CH025
2020-03-02,JU,Jura,0,0,1,0,0,0,2020-02-26,6,CH025
2020-03-03,JU,Jura,1,0,2,0,1,1,2020-02-26,7,CH025
2020-03-04,JU,Jura,3,0,5,0,0,1,2020-02-26,8,CH025
2020-03-05,JU,Jura,0,0,5,0,0,1,2020-02-26,9,CH025
2020-03-06,JU,Jura,0,0,5,0,2,3,2020-02-26,10,CH025
2020-03-07,JU,Jura,0,0,5,0,0,3,2020-02-26,11,CH025
2020-03-08,JU,Jura,1,0,6,0,0,3,2020-02-26,12,CH025
2020-03-09,JU,Jura,1,0,7,0,1,4,2020-02-26,13,CH025
2020-03-10,JU,Jura,3,0,10,0,0,4,2020-02-26,14,CH025
2020-03-11,JU,Jura,0,0,10,0,0,4,2020-02-26,15,CH025
2020-03-12,JU,Jura,4,0,14,0,1,5,2020-02-26,16,CH025
2020-03-13,JU,Jura,3,0,17,0,1,6,2020-02-26,17,CH025
2020-03-14,JU,Jura,4,0,21,0,0,6,2020-02-26,18,CH025
2020-03-15,JU,Jura,3,0,24,0,0,6,2020-02-26,19,CH025
2020-03-16,JU,Jura,3,0,27,0,1,7,2020-02-26,20,CH025
2020-03-17,JU,Jura,4,0,31,0,2,9,2020-02-26,21,CH025
2020-03-18,JU,Jura,8,0,39,0,0,9,2020-02-26,22,CH025
2020-03-19,JU,Jura,7,0,46,0,3,12,2020-02-26,23,CH025
2020-03-20,JU,Jura,11,0,57,0,4,16,2020-02-26,24,CH025
2020-03-21,JU,Jura,4,0,61,0,1,17,2020-02-26,25,CH025
2020-03-22,JU,Jura,4,0,65,0,1,18,2020-02-26,26,CH025
2020-03-23,JU,Jura,18,0,83,0,2,20,2020-02-26,27,CH025
2020-03-24,JU,Jura,12,0,95,0,4,24,2020-02-26,28,CH025
2020-03-25,JU,Jura,13,0,108,0,3,27,2020-02-26,29,CH025
2020-03-26,JU,Jura,10,0,118,0,1,28,2020-02-26,30,CH025
2020-03-27,JU,Jura,10,0,128,0,4,32,2020-02-26,31,CH025
2020-03-28,JU,Jura,4,0,132,0,0,32,2020-02-26,32,CH025
2020-03-29,JU,Jura,2,0,134,0,0,32,2020-02-26,33,CH025
2020-03-30,JU,Jura,12,0,146,0,4,36,2020-02-26,34,CH025
2020-03-31,JU,Jura,4,0,150,0,0,36,2020-02-26,35,CH025
2020-04-01,JU,Jura,4,0,154,0,1,37,2020-02-26,36,CH025
2020-04-02,JU,Jura,0,0,154,0,0,37,2020-02-26,37,CH025
2020-04-03,JU,Jura,7,0,161,0,1,38,2020-02-26,38,CH025
2020-04-04,JU,Jura,4,0,165,0,0,38,2020-02-26,39,CH025
2020-04-05,JU,Jura,5,0,170,0,2,40,2020-02-26,40,CH025
2020-04-06,JU,Jura,3,0,173,0,0,40,2020-02-26,41,CH025
2020-04-07,JU,Jura,5,0,178,0,1,41,2020-02-26,42,CH025
2020-04-08,JU,Jura,5,0,183,0,2,43,2020-02-26,43,CH025
2020-04-09,JU,Jura,1,0,184,0,0,43,2020-02-26,44,CH025
2020-04-10,JU,Jura,1,2,185,2,0,43,2020-02-26,45,CH025
2020-04-11,JU,Jura,1,0,186,2,0,43,2020-02-26,46,CH025
2020-04-12,JU,Jura,0,0,186,2,0,43,2020-02-26,47,CH025
2020-04-13,JU,Jura,4,0,190,2,3,46,2020-02-26,48,CH025
2020-04-14,JU,Jura,0,0,190,2,0,46,2020-02-26,49,CH025
2020-04-15,JU,Jura,1,0,191,2,0,46,2020-02-26,50,CH025
2020-04-16,JU,Jura,2,0,193,2,0,46,2020-02-26,51,CH025
2020-04-17,JU,Jura,2,0,195,2,0,46,2020-02-26,52,CH025
2020-04-18,JU,Jura,0,0,195,2,0,46,2020-02-26,53,CH025
2020-04-19,JU,Jura,3,1,198,3,1,47,2020-02-26,54,CH025
2020-04-20,JU,Jura,1,0,199,3,0,47,2020-02-26,55,CH025
2020-04-21,JU,Jura,1,0,200,3,0,47,2020-02-26,56,CH025
2020-04-22,JU,Jura,0,0,200,3,1,48,2020-02-26,57,CH025
2020-04-23,JU,Jura,0,0,200,3,0,48,2020-02-26,58,CH025
2020-04-24,JU,Jura,0,0,200,3,1,49,2020-02-26,59,CH025
2020-04-25,JU,Jura,0,0,200,3,0,49,2020-02-26,60,CH025
2020-04-26,JU,Jura,0,0,200,3,0,49,2020-02-26,61,CH025
2020-04-27,JU,Jura,1,1,201,4,0,49,2020-02-26,62,CH025
2020-04-28,JU,Jura,0,0,201,4,0,49,2020-02-26,63,CH025
2020-04-29,JU,Jura,1,0,202,4,0,49,2020-02-26,64,CH025
2020-04-30,JU,Jura,0,0,202,4,0,49,2020-02-26,65,CH025
2020-05-01,JU,Jura,0,0,202,4,0,49,2020-02-26,66,CH025
2020-05-02,JU,Jura,0,0,202,4,0,49,2020-02-26,67,CH025
2020-05-03,JU,Jura,0,0,202,4,0,49,2020-02-26,68,CH025
2020-05-04,JU,Jura,1,0,203,4,0,49,2020-02-26,69,CH025
2020-05-05,JU,Jura,1,0,204,4,0,49,2020-02-26,70,CH025
2020-05-06,JU,Jura,0,0,204,4,0,49,2020-02-26,71,CH025
2020-05-07,JU,Jura,1,0,205,4,0,49,2020-02-26,72,CH025
2020-05-08,JU,Jura,0,0,205,4,0,49,2020-02-26,73,CH025
2020-05-09,JU,Jura,0,0,205,4,0,49,2020-02-26,74,CH025
2020-05-10,JU,Jura,0,0,205,4,0,49,2020-02-26,75,CH025
2020-05-11,JU,Jura,0,0,205,4,0,49,2020-02-26,76,CH025
2020-05-12,JU,Jura,0,0,205,4,0,49,2020-02-26,77,CH025
2020-05-13,JU,Jura,0,0,205,4,0,49,2020-02-26,78,CH025
2020-05-14,JU,Jura,0,0,205,4,0,49,2020-02-26,79,CH025
2020-05-15,JU,Jura,0,0,205,4,0,49,2020-02-26,80,CH025
2020-05-16,JU,Jura,0,0,205,4,0,49,2020-02-26,81,CH025
2020-05-17,JU,Jura,0,0,205,4,1,50,2020-02-26,82,CH025
2020-05-18,JU,Jura,1,0,206,4,0,50,2020-02-26,83,CH025
2020-05-19,JU,Jura,0,0,206,4,0,50,2020-02-26,84,CH025
2020-05-20,JU,Jura,0,0,206,4,0,50,2020-02-26,85,CH025
2020-05-21,JU,Jura,0,0,206,4,2,52,2020-02-26,86,CH025
2020-05-22,JU,Jura,0,0,206,4,0,52,2020-02-26,87,CH025
2020-05-23,JU,Jura,0,0,206,4,0,52,2020-02-26,88,CH025
2020-02-24,LU,Luzern,0,0,0,0,0,0,2020-03-03,-7,CH061
2020-02-25,LU,Luzern,0,0,0,0,0,0,2020-03-03,-6,CH061
2020-02-26,LU,Luzern,0,0,0,0,0,0,2020-03-03,-5,CH061
2020-02-27,LU,Luzern,0,0,0,0,0,0,2020-03-03,-4,CH061
2020-02-28,LU,Luzern,0,0,0,0,0,0,2020-03-03,-3,CH061
2020-02-29,LU,Luzern,0,0,0,0,0,0,2020-03-03,-2,CH061
2020-03-01,LU,Luzern,0,0,0,0,0,0,2020-03-03,-1,CH061
2020-03-02,LU,Luzern,0,0,0,0,0,0,2020-03-03,0,CH061
2020-03-03,LU,Luzern,1,0,1,0,0,0,2020-03-03,1,CH061
2020-03-04,LU,Luzern,3,0,4,0,1,1,2020-03-03,2,CH061
2020-03-05,LU,Luzern,0,0,4,0,0,1,2020-03-03,3,CH061
2020-03-06,LU,Luzern,2,0,6,0,0,1,2020-03-03,4,CH061
2020-03-07,LU,Luzern,0,0,6,0,0,1,2020-03-03,5,CH061
2020-03-08,LU,Luzern,1,0,7,0,0,1,2020-03-03,6,CH061
2020-03-09,LU,Luzern,1,0,8,0,0,1,2020-03-03,7,CH061
2020-03-10,LU,Luzern,2,0,10,0,1,2,2020-03-03,8,CH061
2020-03-11,LU,Luzern,3,0,13,0,1,3,2020-03-03,9,CH061
2020-03-12,LU,Luzern,7,0,20,0,1,4,2020-03-03,10,CH061
2020-03-13,LU,Luzern,4,0,24,0,1,5,2020-03-03,11,CH061
2020-03-14,LU,Luzern,8,0,32,0,2,7,2020-03-03,12,CH061
2020-03-15,LU,Luzern,5,0,37,0,1,8,2020-03-03,13,CH061
2020-03-16,LU,Luzern,24,0,61,0,0,8,2020-03-03,14,CH061
2020-03-17,LU,Luzern,25,0,86,0,1,9,2020-03-03,15,CH061
2020-03-18,LU,Luzern,32,0,118,0,0,9,2020-03-03,16,CH061
2020-03-19,LU,Luzern,14,0,132,0,1,10,2020-03-03,17,CH061
2020-03-20,LU,Luzern,26,0,158,0,0,10,2020-03-03,18,CH061
2020-03-21,LU,Luzern,13,1,171,1,2,12,2020-03-03,19,CH061
2020-03-22,LU,Luzern,15,0,186,1,5,17,2020-03-03,20,CH061
2020-03-23,LU,Luzern,42,0,228,1,1,18,2020-03-03,21,CH061
2020-03-24,LU,Luzern,22,1,250,2,2,20,2020-03-03,22,CH061
2020-03-25,LU,Luzern,24,1,274,3,6,26,2020-03-03,23,CH061
2020-03-26,LU,Luzern,46,0,320,3,3,29,2020-03-03,24,CH061
2020-03-27,LU,Luzern,20,0,340,3,2,31,2020-03-03,25,CH061
2020-03-28,LU,Luzern,12,2,352,5,1,32,2020-03-03,26,CH061
2020-03-29,LU,Luzern,12,1,364,6,2,34,2020-03-03,27,CH061
2020-03-30,LU,Luzern,24,1,388,7,1,35,2020-03-03,28,CH061
2020-03-31,LU,Luzern,22,0,410,7,0,35,2020-03-03,29,CH061
2020-04-01,LU,Luzern,20,0,430,7,2,37,2020-03-03,30,CH061
2020-04-02,LU,Luzern,21,0,451,7,0,37,2020-03-03,31,CH061
2020-04-03,LU,Luzern,23,0,474,7,4,41,2020-03-03,32,CH061
2020-04-04,LU,Luzern,13,2,487,9,2,43,2020-03-03,33,CH061
2020-04-05,LU,Luzern,4,0,491,9,2,45,2020-03-03,34,CH061
2020-04-06,LU,Luzern,10,0,501,9,0,45,2020-03-03,35,CH061
2020-04-07,LU,Luzern,16,0,517,9,0,45,2020-03-03,36,CH061
2020-04-08,LU,Luzern,17,0,534,9,1,46,2020-03-03,37,CH061
2020-04-09,LU,Luzern,14,0,548,9,2,48,2020-03-03,38,CH061
2020-04-10,LU,Luzern,7,2,555,11,0,48,2020-03-03,39,CH061
2020-04-11,LU,Luzern,3,1,558,12,2,50,2020-03-03,40,CH061
2020-04-12,LU,Luzern,6,0,564,12,2,52,2020-03-03,41,CH061
2020-04-13,LU,Luzern,6,1,570,13,0,52,2020-03-03,42,CH061
2020-04-14,LU,Luzern,5,1,575,14,1,53,2020-03-03,43,CH061
2020-04-15,LU,Luzern,4,0,579,14,0,53,2020-03-03,44,CH061
2020-04-16,LU,Luzern,14,1,593,15,2,55,2020-03-03,45,CH061
2020-04-17,LU,Luzern,10,1,603,16,3,58,2020-03-03,46,CH061
2020-04-18,LU,Luzern,9,0,612,16,0,58,2020-03-03,47,CH061
2020-04-19,LU,Luzern,3,0,615,16,0,58,2020-03-03,48,CH061
2020-04-20,LU,Luzern,6,0,621,16,1,59,2020-03-03,49,CH061
2020-04-21,LU,Luzern,6,0,627,16,2,61,2020-03-03,50,CH061
2020-04-22,LU,Luzern,7,0,634,16,0,61,2020-03-03,51,CH061
2020-04-23,LU,Luzern,5,1,639,17,0,61,2020-03-03,52,CH061
2020-04-24,LU,Luzern,8,0,647,17,1,62,2020-03-03,53,CH061
2020-04-25,LU,Luzern,3,0,650,17,0,62,2020-03-03,54,CH061
2020-04-26,LU,Luzern,5,1,655,18,1,63,2020-03-03,55,CH061
2020-04-27,LU,Luzern,7,0,662,18,0,63,2020-03-03,56,CH061
2020-04-28,LU,Luzern,5,0,667,18,0,63,2020-03-03,57,CH061
2020-04-29,LU,Luzern,9,0,676,18,2,65,2020-03-03,58,CH061
2020-04-30,LU,Luzern,2,0,678,18,0,65,2020-03-03,59,CH061
2020-05-01,LU,Luzern,1,1,679,19,0,65,2020-03-03,60,CH061
2020-05-02,LU,Luzern,0,0,679,19,0,65,2020-03-03,61,CH061
2020-05-03,LU,Luzern,0,1,679,20,1,66,2020-03-03,62,CH061
2020-05-04,LU,Luzern,2,0,681,20,0,66,2020-03-03,63,CH061
2020-05-05,LU,Luzern,1,0,682,20,0,66,2020-03-03,64,CH061
2020-05-06,LU,Luzern,3,0,685,20,0,66,2020-03-03,65,CH061
2020-05-07,LU,Luzern,1,0,686,20,0,66,2020-03-03,66,CH061
2020-05-08,LU,Luzern,0,0,686,20,0,66,2020-03-03,67,CH061
2020-05-09,LU,Luzern,0,0,686,20,0,66,2020-03-03,68,CH061
2020-05-10,LU,Luzern,1,0,687,20,0,66,2020-03-03,69,CH061
2020-05-11,LU,Luzern,1,0,688,20,0,66,2020-03-03,70,CH061
2020-05-12,LU,Luzern,0,0,688,20,0,66,2020-03-03,71,CH061
2020-05-13,LU,Luzern,0,0,688,20,0,66,2020-03-03,72,CH061
2020-05-14,LU,Luzern,3,0,691,20,0,66,2020-03-03,73,CH061
2020-05-15,LU,Luzern,3,0,694,20,0,66,2020-03-03,74,CH061
2020-05-16,LU,Luzern,2,0,696,20,0,66,2020-03-03,75,CH061
2020-05-17,LU,Luzern,0,0,696,20,0,66,2020-03-03,76,CH061
2020-05-18,LU,Luzern,5,0,701,20,0,66,2020-03-03,77,CH061
2020-05-19,LU,Luzern,0,0,701,20,0,66,2020-03-03,78,CH061
2020-05-20,LU,Luzern,0,0,701,20,0,66,2020-03-03,79,CH061
2020-05-21,LU,Luzern,0,0,701,20,0,66,2020-03-03,80,CH061
2020-05-22,LU,Luzern,0,0,701,20,0,66,2020-03-03,81,CH061
2020-05-23,LU,Luzern,0,0,701,20,0,66,2020-03-03,82,CH061
2020-02-24,NE,Neuenburg,0,0,0,0,0,0,2020-03-01,-5,CH024
2020-02-25,NE,Neuenburg,0,0,0,0,0,0,2020-03-01,-4,CH024
2020-02-26,NE,Neuenburg,0,0,0,0,1,1,2020-03-01,-3,CH024
2020-02-27,NE,Neuenburg,0,0,0,0,0,1,2020-03-01,-2,CH024
2020-02-28,NE,Neuenburg,0,0,0,0,0,1,2020-03-01,-1,CH024
2020-02-29,NE,Neuenburg,0,0,0,0,0,1,2020-03-01,0,CH024
2020-03-01,NE,Neuenburg,1,0,1,0,0,1,2020-03-01,1,CH024
2020-03-02,NE,Neuenburg,0,0,1,0,1,2,2020-03-01,2,CH024
2020-03-03,NE,Neuenburg,1,0,2,0,1,3,2020-03-01,3,CH024
2020-03-04,NE,Neuenburg,7,0,9,0,0,3,2020-03-01,4,CH024
2020-03-05,NE,Neuenburg,1,0,10,0,1,4,2020-03-01,5,CH024
2020-03-06,NE,Neuenburg,4,0,14,0,3,7,2020-03-01,6,CH024
2020-03-07,NE,Neuenburg,5,0,19,0,1,8,2020-03-01,7,CH024
2020-03-08,NE,Neuenburg,6,0,25,0,0,8,2020-03-01,8,CH024
2020-03-09,NE,Neuenburg,3,0,28,0,1,9,2020-03-01,9,CH024
2020-03-10,NE,Neuenburg,4,0,32,0,1,10,2020-03-01,10,CH024
2020-03-11,NE,Neuenburg,7,0,39,0,0,10,2020-03-01,11,CH024
2020-03-12,NE,Neuenburg,3,0,42,0,2,12,2020-03-01,12,CH024
2020-03-13,NE,Neuenburg,13,0,55,0,1,13,2020-03-01,13,CH024
2020-03-14,NE,Neuenburg,9,0,64,0,3,16,2020-03-01,14,CH024
2020-03-15,NE,Neuenburg,5,0,69,0,2,18,2020-03-01,15,CH024
2020-03-16,NE,Neuenburg,13,0,82,0,4,22,2020-03-01,16,CH024
2020-03-17,NE,Neuenburg,20,1,102,1,4,26,2020-03-01,17,CH024
2020-03-18,NE,Neuenburg,28,1,130,2,1,27,2020-03-01,18,CH024
2020-03-19,NE,Neuenburg,19,1,149,3,1,28,2020-03-01,19,CH024
2020-03-20,NE,Neuenburg,15,0,164,3,2,30,2020-03-01,20,CH024
2020-03-21,NE,Neuenburg,5,0,169,3,1,31,2020-03-01,21,CH024
2020-03-22,NE,Neuenburg,13,0,182,3,6,37,2020-03-01,22,CH024
2020-03-23,NE,Neuenburg,22,0,204,3,8,45,2020-03-01,23,CH024
2020-03-24,NE,Neuenburg,25,1,229,4,7,52,2020-03-01,24,CH024
2020-03-25,NE,Neuenburg,20,2,249,6,2,54,2020-03-01,25,CH024
2020-03-26,NE,Neuenburg,19,2,268,8,3,57,2020-03-01,26,CH024
2020-03-27,NE,Neuenburg,24,1,292,9,6,63,2020-03-01,27,CH024
2020-03-28,NE,Neuenburg,14,1,306,10,3,66,2020-03-01,28,CH024
2020-03-29,NE,Neuenburg,23,2,329,12,0,66,2020-03-01,29,CH024
2020-03-30,NE,Neuenburg,28,1,357,13,8,74,2020-03-01,30,CH024
2020-03-31,NE,Neuenburg,22,2,379,15,1,75,2020-03-01,31,CH024
2020-04-01,NE,Neuenburg,11,2,390,17,3,78,2020-03-01,32,CH024
2020-04-02,NE,Neuenburg,11,1,401,18,2,80,2020-03-01,33,CH024
2020-04-03,NE,Neuenburg,18,0,419,18,1,81,2020-03-01,34,CH024
2020-04-04,NE,Neuenburg,2,1,421,19,0,81,2020-03-01,35,CH024
2020-04-05,NE,Neuenburg,11,0,432,19,4,85,2020-03-01,36,CH024
2020-04-06,NE,Neuenburg,27,5,459,24,2,87,2020-03-01,37,CH024
2020-04-07,NE,Neuenburg,24,0,483,24,4,91,2020-03-01,38,CH024
2020-04-08,NE,Neuenburg,4,0,487,24,3,94,2020-03-01,39,CH024
2020-04-09,NE,Neuenburg,21,0,508,24,2,96,2020-03-01,40,CH024
2020-04-10,NE,Neuenburg,18,0,526,24,2,98,2020-03-01,41,CH024
2020-04-11,NE,Neuenburg,17,1,543,25,2,100,2020-03-01,42,CH024
2020-04-12,NE,Neuenburg,5,1,548,26,2,102,2020-03-01,43,CH024
2020-04-13,NE,Neuenburg,19,1,567,27,0,102,2020-03-01,44,CH024
2020-04-14,NE,Neuenburg,12,1,579,28,0,102,2020-03-01,45,CH024
2020-04-15,NE,Neuenburg,13,0,592,28,1,103,2020-03-01,46,CH024
2020-04-16,NE,Neuenburg,3,2,595,30,0,103,2020-03-01,47,CH024
2020-04-17,NE,Neuenburg,9,2,604,32,0,103,2020-03-01,48,CH024
2020-04-18,NE,Neuenburg,0,0,604,32,0,103,2020-03-01,49,CH024
2020-04-19,NE,Neuenburg,4,2,608,34,1,104,2020-03-01,50,CH024
2020-04-20,NE,Neuenburg,9,2,617,36,1,105,2020-03-01,51,CH024
2020-04-21,NE,Neuenburg,6,1,623,37,0,105,2020-03-01,52,CH024
2020-04-22,NE,Neuenburg,7,2,630,39,2,107,2020-03-01,53,CH024
2020-04-23,NE,Neuenburg,6,0,636,39,2,109,2020-03-01,54,CH024
2020-04-24,NE,Neuenburg,2,2,638,41,0,109,2020-03-01,55,CH024
2020-04-25,NE,Neuenburg,0,0,638,41,0,109,2020-03-01,56,CH024
2020-04-26,NE,Neuenburg,2,2,640,43,0,109,2020-03-01,57,CH024
2020-04-27,NE,Neuenburg,2,0,642,43,1,110,2020-03-01,58,CH024
2020-04-28,NE,Neuenburg,5,1,647,44,0,110,2020-03-01,59,CH024
2020-04-29,NE,Neuenburg,4,0,651,44,0,110,2020-03-01,60,CH024
2020-04-30,NE,Neuenburg,3,1,654,45,0,110,2020-03-01,61,CH024
2020-05-01,NE,Neuenburg,2,0,656,45,1,111,2020-03-01,62,CH024
2020-05-02,NE,Neuenburg,1,0,657,45,1,112,2020-03-01,63,CH024
2020-05-03,NE,Neuenburg,2,1,659,46,0,112,2020-03-01,64,CH024
2020-05-04,NE,Neuenburg,2,0,661,46,0,112,2020-03-01,65,CH024
2020-05-05,NE,Neuenburg,2,0,663,46,0,112,2020-03-01,66,CH024
2020-05-06,NE,Neuenburg,4,0,667,46,0,112,2020-03-01,67,CH024
2020-05-07,NE,Neuenburg,2,1,669,47,0,112,2020-03-01,68,CH024
2020-05-08,NE,Neuenburg,3,0,672,47,1,113,2020-03-01,69,CH024
2020-05-09,NE,Neuenburg,1,0,673,47,0,113,2020-03-01,70,CH024
2020-05-10,NE,Neuenburg,1,0,674,47,0,113,2020-03-01,71,CH024
2020-05-11,NE,Neuenburg,2,0,676,47,0,113,2020-03-01,72,CH024
2020-05-12,NE,Neuenburg,2,0,678,47,0,113,2020-03-01,73,CH024
2020-05-13,NE,Neuenburg,0,0,678,47,0,113,2020-03-01,74,CH024
2020-05-14,NE,Neuenburg,0,0,678,47,0,113,2020-03-01,75,CH024
2020-05-15,NE,Neuenburg,0,1,678,48,0,113,2020-03-01,76,CH024
2020-05-16,NE,Neuenburg,0,0,678,48,0,113,2020-03-01,77,CH024
2020-05-17,NE,Neuenburg,0,0,678,48,0,113,2020-03-01,78,CH024
2020-05-18,NE,Neuenburg,1,0,679,48,0,113,2020-03-01,79,CH024
2020-05-19,NE,Neuenburg,1,0,680,48,0,113,2020-03-01,80,CH024
2020-05-20,NE,Neuenburg,0,0,680,48,0,113,2020-03-01,81,CH024
2020-05-21,NE,Neuenburg,0,0,680,48,0,113,2020-03-01,82,CH024
2020-05-22,NE,Neuenburg,0,0,680,48,0,113,2020-03-01,83,CH024
2020-05-23,NE,Neuenburg,0,0,680,48,0,113,2020-03-01,84,CH024
2020-02-24,NW,Nidwalden,0,0,0,0,0,0,2020-03-08,-12,CH065
2020-02-25,NW,Nidwalden,0,0,0,0,0,0,2020-03-08,-11,CH065
2020-02-26,NW,Nidwalden,0,0,0,0,0,0,2020-03-08,-10,CH065
2020-02-27,NW,Nidwalden,0,0,0,0,0,0,2020-03-08,-9,CH065
2020-02-28,NW,Nidwalden,0,0,0,0,0,0,2020-03-08,-8,CH065
2020-02-29,NW,Nidwalden,0,0,0,0,0,0,2020-03-08,-7,CH065
2020-03-01,NW,Nidwalden,0,0,0,0,0,0,2020-03-08,-6,CH065
2020-03-02,NW,Nidwalden,0,0,0,0,0,0,2020-03-08,-5,CH065
2020-03-03,NW,Nidwalden,0,0,0,0,0,0,2020-03-08,-4,CH065
2020-03-04,NW,Nidwalden,0,0,0,0,0,0,2020-03-08,-3,CH065
2020-03-05,NW,Nidwalden,0,0,0,0,0,0,2020-03-08,-2,CH065
2020-03-06,NW,Nidwalden,0,0,0,0,0,0,2020-03-08,-1,CH065
2020-03-07,NW,Nidwalden,0,0,0,0,0,0,2020-03-08,0,CH065
2020-03-08,NW,Nidwalden,1,0,1,0,2,2,2020-03-08,1,CH065
2020-03-09,NW,Nidwalden,4,0,5,0,0,2,2020-03-08,2,CH065
2020-03-10,NW,Nidwalden,2,0,7,0,0,2,2020-03-08,3,CH065
2020-03-11,NW,Nidwalden,0,0,7,0,0,2,2020-03-08,4,CH065
2020-03-12,NW,Nidwalden,0,0,7,0,0,2,2020-03-08,5,CH065
2020-03-13,NW,Nidwalden,2,0,9,0,0,2,2020-03-08,6,CH065
2020-03-14,NW,Nidwalden,2,0,11,0,0,2,2020-03-08,7,CH065
2020-03-15,NW,Nidwalden,0,0,11,0,1,3,2020-03-08,8,CH065
2020-03-16,NW,Nidwalden,15,0,26,0,1,4,2020-03-08,9,CH065
2020-03-17,NW,Nidwalden,2,0,28,0,0,4,2020-03-08,10,CH065
2020-03-18,NW,Nidwalden,4,0,32,0,1,5,2020-03-08,11,CH065
2020-03-19,NW,Nidwalden,2,0,34,0,0,5,2020-03-08,12,CH065
2020-03-20,NW,Nidwalden,5,0,39,0,1,6,2020-03-08,13,CH065
2020-03-21,NW,Nidwalden,2,0,41,0,0,6,2020-03-08,14,CH065
2020-03-22,NW,Nidwalden,2,0,43,0,0,6,2020-03-08,15,CH065
2020-03-23,NW,Nidwalden,2,0,45,0,0,6,2020-03-08,16,CH065
2020-03-24,NW,Nidwalden,3,0,48,0,0,6,2020-03-08,17,CH065
2020-03-25,NW,Nidwalden,6,0,54,0,0,6,2020-03-08,18,CH065
2020-03-26,NW,Nidwalden,4,0,58,0,0,6,2020-03-08,19,CH065
2020-03-27,NW,Nidwalden,13,0,71,0,1,7,2020-03-08,20,CH065
2020-03-28,NW,Nidwalden,2,0,73,0,2,9,2020-03-08,21,CH065
2020-03-29,NW,Nidwalden,0,0,73,0,0,9,2020-03-08,22,CH065
2020-03-30,NW,Nidwalden,5,0,78,0,2,11,2020-03-08,23,CH065
2020-03-31,NW,Nidwalden,3,0,81,0,2,13,2020-03-08,24,CH065
2020-04-01,NW,Nidwalden,2,0,83,0,0,13,2020-03-08,25,CH065
2020-04-02,NW,Nidwalden,3,0,86,0,0,13,2020-03-08,26,CH065
2020-04-03,NW,Nidwalden,3,0,89,0,1,14,2020-03-08,27,CH065
2020-04-04,NW,Nidwalden,2,0,91,0,0,14,2020-03-08,28,CH065
2020-04-05,NW,Nidwalden,0,0,91,0,0,14,2020-03-08,29,CH065
2020-04-06,NW,Nidwalden,6,0,97,0,1,15,2020-03-08,30,CH065
2020-04-07,NW,Nidwalden,2,0,99,0,0,15,2020-03-08,31,CH065
2020-04-08,NW,Nidwalden,3,0,102,0,2,17,2020-03-08,32,CH065
2020-04-09,NW,Nidwalden,1,0,103,0,1,18,2020-03-08,33,CH065
2020-04-10,NW,Nidwalden,1,0,104,0,0,18,2020-03-08,34,CH065
2020-04-11,NW,Nidwalden,1,1,105,1,1,19,2020-03-08,35,CH065
2020-04-12,NW,Nidwalden,1,0,106,1,1,20,2020-03-08,36,CH065
2020-04-13,NW,Nidwalden,0,0,106,1,0,20,2020-03-08,37,CH065
2020-04-14,NW,Nidwalden,0,1,106,2,0,20,2020-03-08,38,CH065
2020-04-15,NW,Nidwalden,2,0,108,2,0,20,2020-03-08,39,CH065
2020-04-16,NW,Nidwalden,0,0,108,2,0,20,2020-03-08,40,CH065
2020-04-17,NW,Nidwalden,0,1,108,3,0,20,2020-03-08,41,CH065
2020-04-18,NW,Nidwalden,0,0,108,3,0,20,2020-03-08,42,CH065
2020-04-19,NW,Nidwalden,0,0,108,3,0,20,2020-03-08,43,CH065
2020-04-20,NW,Nidwalden,0,0,108,3,0,20,2020-03-08,44,CH065
2020-04-21,NW,Nidwalden,0,0,108,3,0,20,2020-03-08,45,CH065
2020-04-22,NW,Nidwalden,0,0,108,3,0,20,2020-03-08,46,CH065
2020-04-23,NW,Nidwalden,1,0,109,3,0,20,2020-03-08,47,CH065
2020-04-24,NW,Nidwalden,1,0,110,3,0,20,2020-03-08,48,CH065
2020-04-25,NW,Nidwalden,0,0,110,3,0,20,2020-03-08,49,CH065
2020-04-26,NW,Nidwalden,1,0,111,3,0,20,2020-03-08,50,CH065
2020-04-27,NW,Nidwalden,1,0,112,3,0,20,2020-03-08,51,CH065
2020-04-28,NW,Nidwalden,0,0,112,3,0,20,2020-03-08,52,CH065
2020-04-29,NW,Nidwalden,0,0,112,3,0,20,2020-03-08,53,CH065
2020-04-30,NW,Nidwalden,0,0,112,3,0,20,2020-03-08,54,CH065
2020-05-01,NW,Nidwalden,0,0,112,3,0,20,2020-03-08,55,CH065
2020-05-02,NW,Nidwalden,0,0,112,3,0,20,2020-03-08,56,CH065
2020-05-03,NW,Nidwalden,0,0,112,3,0,20,2020-03-08,57,CH065
2020-05-04,NW,Nidwalden,1,0,113,3,0,20,2020-03-08,58,CH065
2020-05-05,NW,Nidwalden,0,0,113,3,0,20,2020-03-08,59,CH065
2020-05-06,NW,Nidwalden,0,0,113,3,1,21,2020-03-08,60,CH065
2020-05-07,NW,Nidwalden,0,0,113,3,0,21,2020-03-08,61,CH065
2020-05-08,NW,Nidwalden,1,0,114,3,0,21,2020-03-08,62,CH065
2020-05-09,NW,Nidwalden,2,0,116,3,0,21,2020-03-08,63,CH065
2020-05-10,NW,Nidwalden,1,0,117,3,1,22,2020-03-08,64,CH065
2020-05-11,NW,Nidwalden,0,0,117,3,0,22,2020-03-08,65,CH065
2020-05-12,NW,Nidwalden,3,0,120,3,1,23,2020-03-08,66,CH065
2020-05-13,NW,Nidwalden,0,0,120,3,0,23,2020-03-08,67,CH065
2020-05-14,NW,Nidwalden,0,0,120,3,0,23,2020-03-08,68,CH065
2020-05-15,NW,Nidwalden,1,0,121,3,0,23,2020-03-08,69,CH065
2020-05-16,NW,Nidwalden,0,0,121,3,0,23,2020-03-08,70,CH065
2020-05-17,NW,Nidwalden,0,0,121,3,0,23,2020-03-08,71,CH065
2020-05-18,NW,Nidwalden,0,0,121,3,0,23,2020-03-08,72,CH065
2020-05-19,NW,Nidwalden,0,0,121,3,0,23,2020-03-08,73,CH065
2020-05-20,NW,Nidwalden,0,0,121,3,0,23,2020-03-08,74,CH065
2020-05-21,NW,Nidwalden,0,0,121,3,0,23,2020-03-08,75,CH065
2020-05-22,NW,Nidwalden,0,0,121,3,0,23,2020-03-08,76,CH065
2020-05-23,NW,Nidwalden,0,0,121,3,0,23,2020-03-08,77,CH065
2020-02-24,OW,Obwalden,0,0,0,0,0,0,2020-03-10,-14,CH064
2020-02-25,OW,Obwalden,0,0,0,0,0,0,2020-03-10,-13,CH064
2020-02-26,OW,Obwalden,0,0,0,0,0,0,2020-03-10,-12,CH064
2020-02-27,OW,Obwalden,0,0,0,0,0,0,2020-03-10,-11,CH064
2020-02-28,OW,Obwalden,0,0,0,0,0,0,2020-03-10,-10,CH064
2020-02-29,OW,Obwalden,0,0,0,0,0,0,2020-03-10,-9,CH064
2020-03-01,OW,Obwalden,0,0,0,0,0,0,2020-03-10,-8,CH064
2020-03-02,OW,Obwalden,0,0,0,0,0,0,2020-03-10,-7,CH064
2020-03-03,OW,Obwalden,0,0,0,0,0,0,2020-03-10,-6,CH064
2020-03-04,OW,Obwalden,0,0,0,0,0,0,2020-03-10,-5,CH064
2020-03-05,OW,Obwalden,0,0,0,0,0,0,2020-03-10,-4,CH064
2020-03-06,OW,Obwalden,0,0,0,0,0,0,2020-03-10,-3,CH064
2020-03-07,OW,Obwalden,0,0,0,0,0,0,2020-03-10,-2,CH064
2020-03-08,OW,Obwalden,0,0,0,0,0,0,2020-03-10,-1,CH064
2020-03-09,OW,Obwalden,0,0,0,0,0,0,2020-03-10,0,CH064
2020-03-10,OW,Obwalden,1,0,1,0,0,0,2020-03-10,1,CH064
2020-03-11,OW,Obwalden,6,0,7,0,0,0,2020-03-10,2,CH064
2020-03-12,OW,Obwalden,0,0,7,0,0,0,2020-03-10,3,CH064
2020-03-13,OW,Obwalden,3,0,10,0,0,0,2020-03-10,4,CH064
2020-03-14,OW,Obwalden,5,0,15,0,1,1,2020-03-10,5,CH064
2020-03-15,OW,Obwalden,0,0,15,0,0,1,2020-03-10,6,CH064
2020-03-16,OW,Obwalden,2,0,17,0,0,1,2020-03-10,7,CH064
2020-03-17,OW,Obwalden,1,0,18,0,0,1,2020-03-10,8,CH064
2020-03-18,OW,Obwalden,2,0,20,0,0,1,2020-03-10,9,CH064
2020-03-19,OW,Obwalden,0,0,20,0,0,1,2020-03-10,10,CH064
2020-03-20,OW,Obwalden,1,0,21,0,0,1,2020-03-10,11,CH064
2020-03-21,OW,Obwalden,2,0,23,0,0,1,2020-03-10,12,CH064
2020-03-22,OW,Obwalden,2,0,25,0,0,1,2020-03-10,13,CH064
2020-03-23,OW,Obwalden,1,0,26,0,0,1,2020-03-10,14,CH064
2020-03-24,OW,Obwalden,0,0,26,0,0,1,2020-03-10,15,CH064
2020-03-25,OW,Obwalden,2,0,28,0,1,2,2020-03-10,16,CH064
2020-03-26,OW,Obwalden,3,0,31,0,2,4,2020-03-10,17,CH064
2020-03-27,OW,Obwalden,4,0,35,0,1,5,2020-03-10,18,CH064
2020-03-28,OW,Obwalden,2,0,37,0,0,5,2020-03-10,19,CH064
2020-03-29,OW,Obwalden,2,0,39,0,0,5,2020-03-10,20,CH064
2020-03-30,OW,Obwalden,2,0,41,0,0,5,2020-03-10,21,CH064
2020-03-31,OW,Obwalden,1,0,42,0,0,5,2020-03-10,22,CH064
2020-04-01,OW,Obwalden,3,0,45,0,0,5,2020-03-10,23,CH064
2020-04-02,OW,Obwalden,4,0,49,0,0,5,2020-03-10,24,CH064
2020-04-03,OW,Obwalden,0,0,49,0,0,5,2020-03-10,25,CH064
2020-04-04,OW,Obwalden,1,0,50,0,0,5,2020-03-10,26,CH064
2020-04-05,OW,Obwalden,3,0,53,0,0,5,2020-03-10,27,CH064
2020-04-06,OW,Obwalden,1,0,54,0,0,5,2020-03-10,28,CH064
2020-04-07,OW,Obwalden,1,0,55,0,0,5,2020-03-10,29,CH064
2020-04-08,OW,Obwalden,1,0,56,0,0,5,2020-03-10,30,CH064
2020-04-09,OW,Obwalden,0,0,56,0,0,5,2020-03-10,31,CH064
2020-04-10,OW,Obwalden,0,0,56,0,0,5,2020-03-10,32,CH064
2020-04-11,OW,Obwalden,0,0,56,0,0,5,2020-03-10,33,CH064
2020-04-12,OW,Obwalden,0,0,56,0,0,5,2020-03-10,34,CH064
2020-04-13,OW,Obwalden,0,0,56,0,0,5,2020-03-10,35,CH064
2020-04-14,OW,Obwalden,0,0,56,0,0,5,2020-03-10,36,CH064
2020-04-15,OW,Obwalden,1,0,57,0,0,5,2020-03-10,37,CH064
2020-04-16,OW,Obwalden,2,0,59,0,0,5,2020-03-10,38,CH064
2020-04-17,OW,Obwalden,1,0,60,0,0,5,2020-03-10,39,CH064
2020-04-18,OW,Obwalden,0,0,60,0,0,5,2020-03-10,40,CH064
2020-04-19,OW,Obwalden,0,0,60,0,0,5,2020-03-10,41,CH064
2020-04-20,OW,Obwalden,0,0,60,0,0,5,2020-03-10,42,CH064
2020-04-21,OW,Obwalden,0,0,60,0,0,5,2020-03-10,43,CH064
2020-04-22,OW,Obwalden,1,0,61,0,0,5,2020-03-10,44,CH064
2020-04-23,OW,Obwalden,2,0,63,0,0,5,2020-03-10,45,CH064
2020-04-24,OW,Obwalden,1,0,64,0,0,5,2020-03-10,46,CH064
2020-04-25,OW,Obwalden,2,0,66,0,0,5,2020-03-10,47,CH064
2020-04-26,OW,Obwalden,2,0,68,0,0,5,2020-03-10,48,CH064
2020-04-27,OW,Obwalden,2,0,70,0,1,6,2020-03-10,49,CH064
2020-04-28,OW,Obwalden,2,0,72,0,0,6,2020-03-10,50,CH064
2020-04-29,OW,Obwalden,1,0,73,0,0,6,2020-03-10,51,CH064
2020-04-30,OW,Obwalden,0,0,73,0,0,6,2020-03-10,52,CH064
2020-05-01,OW,Obwalden,0,0,73,0,0,6,2020-03-10,53,CH064
2020-05-02,OW,Obwalden,1,0,74,0,0,6,2020-03-10,54,CH064
2020-05-03,OW,Obwalden,0,0,74,0,0,6,2020-03-10,55,CH064
2020-05-04,OW,Obwalden,0,0,74,0,0,6,2020-03-10,56,CH064
2020-05-05,OW,Obwalden,0,0,74,0,0,6,2020-03-10,57,CH064
2020-05-06,OW,Obwalden,0,0,74,0,0,6,2020-03-10,58,CH064
2020-05-07,OW,Obwalden,0,0,74,0,0,6,2020-03-10,59,CH064
2020-05-08,OW,Obwalden,0,0,74,0,0,6,2020-03-10,60,CH064
2020-05-09,OW,Obwalden,0,0,74,0,0,6,2020-03-10,61,CH064
2020-05-10,OW,Obwalden,0,0,74,0,0,6,2020-03-10,62,CH064
2020-05-11,OW,Obwalden,0,0,74,0,0,6,2020-03-10,63,CH064
2020-05-12,OW,Obwalden,0,0,74,0,0,6,2020-03-10,64,CH064
2020-05-13,OW,Obwalden,0,0,74,0,0,6,2020-03-10,65,CH064
2020-05-14,OW,Obwalden,0,0,74,0,0,6,2020-03-10,66,CH064
2020-05-15,OW,Obwalden,0,0,74,0,0,6,2020-03-10,67,CH064
2020-05-16,OW,Obwalden,0,0,74,0,0,6,2020-03-10,68,CH064
2020-05-17,OW,Obwalden,0,0,74,0,0,6,2020-03-10,69,CH064
2020-05-18,OW,Obwalden,1,0,75,0,0,6,2020-03-10,70,CH064
2020-05-19,OW,Obwalden,0,0,75,0,0,6,2020-03-10,71,CH064
2020-05-20,OW,Obwalden,0,0,75,0,0,6,2020-03-10,72,CH064
2020-05-21,OW,Obwalden,0,0,75,0,0,6,2020-03-10,73,CH064
2020-05-22,OW,Obwalden,0,0,75,0,0,6,2020-03-10,74,CH064
2020-05-23,OW,Obwalden,0,0,75,0,0,6,2020-03-10,75,CH064
2020-02-24,SG,St. Gallen,0,0,0,0,0,0,2020-03-02,-6,CH055
2020-02-25,SG,St. Gallen,0,0,0,0,0,0,2020-03-02,-5,CH055
2020-02-26,SG,St. Gallen,0,0,0,0,0,0,2020-03-02,-4,CH055
2020-02-27,SG,St. Gallen,0,0,0,0,0,0,2020-03-02,-3,CH055
2020-02-28,SG,St. Gallen,0,0,0,0,0,0,2020-03-02,-2,CH055
2020-02-29,SG,St. Gallen,0,0,0,0,0,0,2020-03-02,-1,CH055
2020-03-01,SG,St. Gallen,0,0,0,0,0,0,2020-03-02,0,CH055
2020-03-02,SG,St. Gallen,1,0,1,0,0,0,2020-03-02,1,CH055
2020-03-03,SG,St. Gallen,0,0,1,0,0,0,2020-03-02,2,CH055
2020-03-04,SG,St. Gallen,0,0,1,0,0,0,2020-03-02,3,CH055
2020-03-05,SG,St. Gallen,0,0,1,0,0,0,2020-03-02,4,CH055
2020-03-06,SG,St. Gallen,3,0,4,0,0,0,2020-03-02,5,CH055
2020-03-07,SG,St. Gallen,0,0,4,0,0,0,2020-03-02,6,CH055
2020-03-08,SG,St. Gallen,1,0,5,0,0,0,2020-03-02,7,CH055
2020-03-09,SG,St. Gallen,8,0,13,0,0,0,2020-03-02,8,CH055
2020-03-10,SG,St. Gallen,1,0,14,0,0,0,2020-03-02,9,CH055
2020-03-11,SG,St. Gallen,8,0,22,0,2,2,2020-03-02,10,CH055
2020-03-12,SG,St. Gallen,8,0,30,0,1,3,2020-03-02,11,CH055
2020-03-13,SG,St. Gallen,9,0,39,0,1,4,2020-03-02,12,CH055
2020-03-14,SG,St. Gallen,7,0,46,0,0,4,2020-03-02,13,CH055
2020-03-15,SG,St. Gallen,3,0,49,0,0,4,2020-03-02,14,CH055
2020-03-16,SG,St. Gallen,28,0,77,0,2,6,2020-03-02,15,CH055
2020-03-17,SG,St. Gallen,29,0,106,0,1,7,2020-03-02,16,CH055
2020-03-18,SG,St. Gallen,25,0,131,0,0,7,2020-03-02,17,CH055
2020-03-19,SG,St. Gallen,20,0,151,0,2,9,2020-03-02,18,CH055
2020-03-20,SG,St. Gallen,39,0,190,0,3,12,2020-03-02,19,CH055
2020-03-21,SG,St. Gallen,9,0,199,0,1,13,2020-03-02,20,CH055
2020-03-22,SG,St. Gallen,11,0,210,0,7,20,2020-03-02,21,CH055
2020-03-23,SG,St. Gallen,49,0,259,0,2,22,2020-03-02,22,CH055
2020-03-24,SG,St. Gallen,29,0,288,0,4,26,2020-03-02,23,CH055
2020-03-25,SG,St. Gallen,30,2,318,2,5,31,2020-03-02,24,CH055
2020-03-26,SG,St. Gallen,31,1,349,3,5,36,2020-03-02,25,CH055
2020-03-27,SG,St. Gallen,35,1,384,4,8,44,2020-03-02,26,CH055
2020-03-28,SG,St. Gallen,8,1,392,5,3,47,2020-03-02,27,CH055
2020-03-29,SG,St. Gallen,2,0,394,5,3,50,2020-03-02,28,CH055
2020-03-30,SG,St. Gallen,37,1,431,6,8,58,2020-03-02,29,CH055
2020-03-31,SG,St. Gallen,34,1,465,7,3,61,2020-03-02,30,CH055
2020-04-01,SG,St. Gallen,22,0,487,7,5,66,2020-03-02,31,CH055
2020-04-02,SG,St. Gallen,22,0,509,7,1,67,2020-03-02,32,CH055
2020-04-03,SG,St. Gallen,32,2,541,9,3,70,2020-03-02,33,CH055
2020-04-04,SG,St. Gallen,9,1,550,10,1,71,2020-03-02,34,CH055
2020-04-05,SG,St. Gallen,6,1,556,11,0,71,2020-03-02,35,CH055
2020-04-06,SG,St. Gallen,36,4,592,15,4,75,2020-03-02,36,CH055
2020-04-07,SG,St. Gallen,24,2,616,17,1,76,2020-03-02,37,CH055
2020-04-08,SG,St. Gallen,13,0,629,17,2,78,2020-03-02,38,CH055
2020-04-09,SG,St. Gallen,12,2,641,19,2,80,2020-03-02,39,CH055
2020-04-10,SG,St. Gallen,3,0,644,19,0,80,2020-03-02,40,CH055
2020-04-11,SG,St. Gallen,8,1,652,20,1,81,2020-03-02,41,CH055
2020-04-12,SG,St. Gallen,7,1,659,21,0,81,2020-03-02,42,CH055
2020-04-13,SG,St. Gallen,6,0,665,21,1,82,2020-03-02,43,CH055
2020-04-14,SG,St. Gallen,9,1,674,22,1,83,2020-03-02,44,CH055
2020-04-15,SG,St. Gallen,10,2,684,24,2,85,2020-03-02,45,CH055
2020-04-16,SG,St. Gallen,7,3,691,27,0,85,2020-03-02,46,CH055
2020-04-17,SG,St. Gallen,12,1,703,28,0,85,2020-03-02,47,CH055
2020-04-18,SG,St. Gallen,3,0,706,28,0,85,2020-03-02,48,CH055
2020-04-19,SG,St. Gallen,3,0,709,28,2,87,2020-03-02,49,CH055
2020-04-20,SG,St. Gallen,12,1,721,29,1,88,2020-03-02,50,CH055
2020-04-21,SG,St. Gallen,13,1,734,30,1,89,2020-03-02,51,CH055
2020-04-22,SG,St. Gallen,3,0,737,30,1,90,2020-03-02,52,CH055
2020-04-23,SG,St. Gallen,6,0,743,30,0,90,2020-03-02,53,CH055
2020-04-24,SG,St. Gallen,9,0,752,30,2,92,2020-03-02,54,CH055
2020-04-25,SG,St. Gallen,5,0,757,30,2,94,2020-03-02,55,CH055
2020-04-26,SG,St. Gallen,0,1,757,31,0,94,2020-03-02,56,CH055
2020-04-27,SG,St. Gallen,5,0,762,31,0,94,2020-03-02,57,CH055
2020-04-28,SG,St. Gallen,4,0,766,31,2,96,2020-03-02,58,CH055
2020-04-29,SG,St. Gallen,6,0,772,31,1,97,2020-03-02,59,CH055
2020-04-30,SG,St. Gallen,2,0,774,31,1,98,2020-03-02,60,CH055
2020-05-01,SG,St. Gallen,1,0,775,31,0,98,2020-03-02,61,CH055
2020-05-02,SG,St. Gallen,0,0,775,31,0,98,2020-03-02,62,CH055
2020-05-03,SG,St. Gallen,0,1,775,32,0,98,2020-03-02,63,CH055
2020-05-04,SG,St. Gallen,2,0,777,32,0,98,2020-03-02,64,CH055
2020-05-05,SG,St. Gallen,1,0,778,32,0,98,2020-03-02,65,CH055
2020-05-06,SG,St. Gallen,3,1,781,33,0,98,2020-03-02,66,CH055
2020-05-07,SG,St. Gallen,0,0,781,33,0,98,2020-03-02,67,CH055
2020-05-08,SG,St. Gallen,2,0,783,33,0,98,2020-03-02,68,CH055
2020-05-09,SG,St. Gallen,0,0,783,33,0,98,2020-03-02,69,CH055
2020-05-10,SG,St. Gallen,0,1,783,34,0,98,2020-03-02,70,CH055
2020-05-11,SG,St. Gallen,2,0,785,34,0,98,2020-03-02,71,CH055
2020-05-12,SG,St. Gallen,0,0,785,34,0,98,2020-03-02,72,CH055
2020-05-13,SG,St. Gallen,1,0,786,34,0,98,2020-03-02,73,CH055
2020-05-14,SG,St. Gallen,0,0,786,34,0,98,2020-03-02,74,CH055
2020-05-15,SG,St. Gallen,0,0,786,34,0,98,2020-03-02,75,CH055
2020-05-16,SG,St. Gallen,1,0,787,34,0,98,2020-03-02,76,CH055
2020-05-17,SG,St. Gallen,0,0,787,34,0,98,2020-03-02,77,CH055
2020-05-18,SG,St. Gallen,1,0,788,34,0,98,2020-03-02,78,CH055
2020-05-19,SG,St. Gallen,0,0,788,34,0,98,2020-03-02,79,CH055
2020-05-20,SG,St. Gallen,0,0,788,34,0,98,2020-03-02,80,CH055
2020-05-21,SG,St. Gallen,0,0,788,34,0,98,2020-03-02,81,CH055
2020-05-22,SG,St. Gallen,0,0,788,34,0,98,2020-03-02,82,CH055
2020-05-23,SG,St. Gallen,0,0,788,34,0,98,2020-03-02,83,CH055
2020-02-24,SH,Schaffhausen,0,0,0,0,0,0,2020-03-10,-14,CH052
2020-02-25,SH,Schaffhausen,0,0,0,0,0,0,2020-03-10,-13,CH052
2020-02-26,SH,Schaffhausen,0,0,0,0,0,0,2020-03-10,-12,CH052
2020-02-27,SH,Schaffhausen,0,0,0,0,0,0,2020-03-10,-11,CH052
2020-02-28,SH,Schaffhausen,0,0,0,0,0,0,2020-03-10,-10,CH052
2020-02-29,SH,Schaffhausen,0,0,0,0,0,0,2020-03-10,-9,CH052
2020-03-01,SH,Schaffhausen,0,0,0,0,0,0,2020-03-10,-8,CH052
2020-03-02,SH,Schaffhausen,0,0,0,0,0,0,2020-03-10,-7,CH052
2020-03-03,SH,Schaffhausen,0,0,0,0,0,0,2020-03-10,-6,CH052
2020-03-04,SH,Schaffhausen,0,0,0,0,0,0,2020-03-10,-5,CH052
2020-03-05,SH,Schaffhausen,0,0,0,0,0,0,2020-03-10,-4,CH052
2020-03-06,SH,Schaffhausen,0,0,0,0,0,0,2020-03-10,-3,CH052
2020-03-07,SH,Schaffhausen,0,0,0,0,0,0,2020-03-10,-2,CH052
2020-03-08,SH,Schaffhausen,0,0,0,0,0,0,2020-03-10,-1,CH052
2020-03-09,SH,Schaffhausen,0,0,0,0,0,0,2020-03-10,0,CH052
2020-03-10,SH,Schaffhausen,1,0,1,0,0,0,2020-03-10,1,CH052
2020-03-11,SH,Schaffhausen,0,0,1,0,0,0,2020-03-10,2,CH052
2020-03-12,SH,Schaffhausen,0,0,1,0,0,0,2020-03-10,3,CH052
2020-03-13,SH,Schaffhausen,0,0,1,0,0,0,2020-03-10,4,CH052
2020-03-14,SH,Schaffhausen,1,0,2,0,0,0,2020-03-10,5,CH052
2020-03-15,SH,Schaffhausen,0,0,2,0,0,0,2020-03-10,6,CH052
2020-03-16,SH,Schaffhausen,5,0,7,0,2,2,2020-03-10,7,CH052
2020-03-17,SH,Schaffhausen,3,0,10,0,0,2,2020-03-10,8,CH052
2020-03-18,SH,Schaffhausen,3,0,13,0,0,2,2020-03-10,9,CH052
2020-03-19,SH,Schaffhausen,3,0,16,0,0,2,2020-03-10,10,CH052
2020-03-20,SH,Schaffhausen,13,0,29,0,1,3,2020-03-10,11,CH052
2020-03-21,SH,Schaffhausen,2,0,31,0,0,3,2020-03-10,12,CH052
2020-03-22,SH,Schaffhausen,1,0,32,0,0,3,2020-03-10,13,CH052
2020-03-23,SH,Schaffhausen,2,0,34,0,1,4,2020-03-10,14,CH052
2020-03-24,SH,Schaffhausen,1,0,35,0,1,5,2020-03-10,15,CH052
2020-03-25,SH,Schaffhausen,2,0,37,0,1,6,2020-03-10,16,CH052
2020-03-26,SH,Schaffhausen,3,0,40,0,2,8,2020-03-10,17,CH052
2020-03-27,SH,Schaffhausen,0,0,40,0,0,8,2020-03-10,18,CH052
2020-03-28,SH,Schaffhausen,1,0,41,0,0,8,2020-03-10,19,CH052
2020-03-29,SH,Schaffhausen,2,0,43,0,0,8,2020-03-10,20,CH052
2020-03-30,SH,Schaffhausen,1,0,44,0,0,8,2020-03-10,21,CH052
2020-03-31,SH,Schaffhausen,2,1,46,1,0,8,2020-03-10,22,CH052
2020-04-01,SH,Schaffhausen,1,0,47,1,1,9,2020-03-10,23,CH052
2020-04-02,SH,Schaffhausen,1,0,48,1,0,9,2020-03-10,24,CH052
2020-04-03,SH,Schaffhausen,1,0,49,1,0,9,2020-03-10,25,CH052
2020-04-04,SH,Schaffhausen,1,0,50,1,1,10,2020-03-10,26,CH052
2020-04-05,SH,Schaffhausen,0,0,50,1,0,10,2020-03-10,27,CH052
2020-04-06,SH,Schaffhausen,3,0,53,1,0,10,2020-03-10,28,CH052
2020-04-07,SH,Schaffhausen,0,0,53,1,0,10,2020-03-10,29,CH052
2020-04-08,SH,Schaffhausen,2,0,55,1,0,10,2020-03-10,30,CH052
2020-04-09,SH,Schaffhausen,2,0,57,1,0,10,2020-03-10,31,CH052
2020-04-10,SH,Schaffhausen,0,0,57,1,0,10,2020-03-10,32,CH052
2020-04-11,SH,Schaffhausen,0,0,57,1,0,10,2020-03-10,33,CH052
2020-04-12,SH,Schaffhausen,2,0,59,1,0,10,2020-03-10,34,CH052
2020-04-13,SH,Schaffhausen,1,0,60,1,0,10,2020-03-10,35,CH052
2020-04-14,SH,Schaffhausen,0,0,60,1,0,10,2020-03-10,36,CH052
2020-04-15,SH,Schaffhausen,1,0,61,1,0,10,2020-03-10,37,CH052
2020-04-16,SH,Schaffhausen,1,0,62,1,0,10,2020-03-10,38,CH052
2020-04-17,SH,Schaffhausen,1,0,63,1,0,10,2020-03-10,39,CH052
2020-04-18,SH,Schaffhausen,0,0,63,1,0,10,2020-03-10,40,CH052
2020-04-19,SH,Schaffhausen,0,0,63,1,0,10,2020-03-10,41,CH052
2020-04-20,SH,Schaffhausen,1,0,64,1,0,10,2020-03-10,42,CH052
2020-04-21,SH,Schaffhausen,4,0,68,1,1,11,2020-03-10,43,CH052
2020-04-22,SH,Schaffhausen,3,0,71,1,0,11,2020-03-10,44,CH052
2020-04-23,SH,Schaffhausen,1,1,72,2,0,11,2020-03-10,45,CH052
2020-04-24,SH,Schaffhausen,1,0,73,2,0,11,2020-03-10,46,CH052
2020-04-25,SH,Schaffhausen,1,0,74,2,0,11,2020-03-10,47,CH052
2020-04-26,SH,Schaffhausen,0,0,74,2,1,12,2020-03-10,48,CH052
2020-04-27,SH,Schaffhausen,0,0,74,2,0,12,2020-03-10,49,CH052
2020-04-28,SH,Schaffhausen,1,0,75,2,0,12,2020-03-10,50,CH052
2020-04-29,SH,Schaffhausen,0,0,75,2,0,12,2020-03-10,51,CH052
2020-04-30,SH,Schaffhausen,0,0,75,2,0,12,2020-03-10,52,CH052
2020-05-01,SH,Schaffhausen,0,0,75,2,0,12,2020-03-10,53,CH052
2020-05-02,SH,Schaffhausen,0,0,75,2,0,12,2020-03-10,54,CH052
2020-05-03,SH,Schaffhausen,0,0,75,2,0,12,2020-03-10,55,CH052
2020-05-04,SH,Schaffhausen,0,0,75,2,0,12,2020-03-10,56,CH052
2020-05-05,SH,Schaffhausen,1,0,76,2,0,12,2020-03-10,57,CH052
2020-05-06,SH,Schaffhausen,1,0,77,2,0,12,2020-03-10,58,CH052
2020-05-07,SH,Schaffhausen,1,0,78,2,0,12,2020-03-10,59,CH052
2020-05-08,SH,Schaffhausen,0,0,78,2,0,12,2020-03-10,60,CH052
2020-05-09,SH,Schaffhausen,0,0,78,2,0,12,2020-03-10,61,CH052
2020-05-10,SH,Schaffhausen,0,0,78,2,0,12,2020-03-10,62,CH052
2020-05-11,SH,Schaffhausen,0,0,78,2,0,12,2020-03-10,63,CH052
2020-05-12,SH,Schaffhausen,0,0,78,2,0,12,2020-03-10,64,CH052
2020-05-13,SH,Schaffhausen,0,0,78,2,0,12,2020-03-10,65,CH052
2020-05-14,SH,Schaffhausen,0,0,78,2,0,12,2020-03-10,66,CH052
2020-05-15,SH,Schaffhausen,0,0,78,2,0,12,2020-03-10,67,CH052
2020-05-16,SH,Schaffhausen,0,0,78,2,0,12,2020-03-10,68,CH052
2020-05-17,SH,Schaffhausen,0,0,78,2,0,12,2020-03-10,69,CH052
2020-05-18,SH,Schaffhausen,0,0,78,2,0,12,2020-03-10,70,CH052
2020-05-19,SH,Schaffhausen,0,0,78,2,0,12,2020-03-10,71,CH052
2020-05-20,SH,Schaffhausen,0,0,78,2,0,12,2020-03-10,72,CH052
2020-05-21,SH,Schaffhausen,0,0,78,2,0,12,2020-03-10,73,CH052
2020-05-22,SH,Schaffhausen,0,0,78,2,0,12,2020-03-10,74,CH052
2020-05-23,SH,Schaffhausen,0,0,78,2,0,12,2020-03-10,75,CH052
2020-02-24,SO,Solothurn,0,0,0,0,0,0,2020-03-05,-9,CH023
2020-02-25,SO,Solothurn,0,0,0,0,0,0,2020-03-05,-8,CH023
2020-02-26,SO,Solothurn,0,0,0,0,0,0,2020-03-05,-7,CH023
2020-02-27,SO,Solothurn,0,0,0,0,0,0,2020-03-05,-6,CH023
2020-02-28,SO,Solothurn,0,0,0,0,0,0,2020-03-05,-5,CH023
2020-02-29,SO,Solothurn,0,0,0,0,0,0,2020-03-05,-4,CH023
2020-03-01,SO,Solothurn,0,0,0,0,0,0,2020-03-05,-3,CH023
2020-03-02,SO,Solothurn,0,0,0,0,0,0,2020-03-05,-2,CH023
2020-03-03,SO,Solothurn,0,0,0,0,0,0,2020-03-05,-1,CH023
2020-03-04,SO,Solothurn,0,0,0,0,0,0,2020-03-05,0,CH023
2020-03-05,SO,Solothurn,1,0,1,0,0,0,2020-03-05,1,CH023
2020-03-06,SO,Solothurn,0,0,1,0,0,0,2020-03-05,2,CH023
2020-03-07,SO,Solothurn,0,0,1,0,0,0,2020-03-05,3,CH023
2020-03-08,SO,Solothurn,0,0,1,0,0,0,2020-03-05,4,CH023
2020-03-09,SO,Solothurn,2,0,3,0,0,0,2020-03-05,5,CH023
2020-03-10,SO,Solothurn,4,0,7,0,2,2,2020-03-05,6,CH023
2020-03-11,SO,Solothurn,1,0,8,0,0,2,2020-03-05,7,CH023
2020-03-12,SO,Solothurn,3,0,11,0,1,3,2020-03-05,8,CH023
2020-03-13,SO,Solothurn,0,0,11,0,0,3,2020-03-05,9,CH023
2020-03-14,SO,Solothurn,3,0,14,0,0,3,2020-03-05,10,CH023
2020-03-15,SO,Solothurn,4,0,18,0,0,3,2020-03-05,11,CH023
2020-03-16,SO,Solothurn,18,0,36,0,3,6,2020-03-05,12,CH023
2020-03-17,SO,Solothurn,6,0,42,0,3,9,2020-03-05,13,CH023
2020-03-18,SO,Solothurn,11,0,53,0,1,10,2020-03-05,14,CH023
2020-03-19,SO,Solothurn,9,0,62,0,3,13,2020-03-05,15,CH023
2020-03-20,SO,Solothurn,18,0,80,0,4,17,2020-03-05,16,CH023
2020-03-21,SO,Solothurn,6,0,86,0,2,19,2020-03-05,17,CH023
2020-03-22,SO,Solothurn,10,0,96,0,4,23,2020-03-05,18,CH023
2020-03-23,SO,Solothurn,16,1,112,1,4,27,2020-03-05,19,CH023
2020-03-24,SO,Solothurn,21,0,133,1,4,31,2020-03-05,20,CH023
2020-03-25,SO,Solothurn,14,0,147,1,7,38,2020-03-05,21,CH023
2020-03-26,SO,Solothurn,15,0,162,1,1,39,2020-03-05,22,CH023
2020-03-27,SO,Solothurn,20,1,182,2,3,42,2020-03-05,23,CH023
2020-03-28,SO,Solothurn,3,0,185,2,4,46,2020-03-05,24,CH023
2020-03-29,SO,Solothurn,5,0,190,2,1,47,2020-03-05,25,CH023
2020-03-30,SO,Solothurn,18,0,208,2,1,48,2020-03-05,26,CH023
2020-03-31,SO,Solothurn,10,1,218,3,1,49,2020-03-05,27,CH023
2020-04-01,SO,Solothurn,8,0,226,3,3,52,2020-03-05,28,CH023
2020-04-02,SO,Solothurn,13,0,239,3,1,53,2020-03-05,29,CH023
2020-04-03,SO,Solothurn,8,0,247,3,0,53,2020-03-05,30,CH023
2020-04-04,SO,Solothurn,4,0,251,3,1,54,2020-03-05,31,CH023
2020-04-05,SO,Solothurn,2,0,253,3,0,54,2020-03-05,32,CH023
2020-04-06,SO,Solothurn,17,0,270,3,1,55,2020-03-05,33,CH023
2020-04-07,SO,Solothurn,5,1,275,4,1,56,2020-03-05,34,CH023
2020-04-08,SO,Solothurn,9,1,284,5,3,59,2020-03-05,35,CH023
2020-04-09,SO,Solothurn,11,1,295,6,2,61,2020-03-05,36,CH023
2020-04-10,SO,Solothurn,5,0,300,6,0,61,2020-03-05,37,CH023
2020-04-11,SO,Solothurn,7,1,307,7,0,61,2020-03-05,38,CH023
2020-04-12,SO,Solothurn,3,0,310,7,0,61,2020-03-05,39,CH023
2020-04-13,SO,Solothurn,2,1,312,8,2,63,2020-03-05,40,CH023
2020-04-14,SO,Solothurn,12,0,324,8,2,65,2020-03-05,41,CH023
2020-04-15,SO,Solothurn,6,1,330,9,2,67,2020-03-05,42,CH023
2020-04-16,SO,Solothurn,5,0,335,9,1,68,2020-03-05,43,CH023
2020-04-17,SO,Solothurn,3,1,338,10,1,69,2020-03-05,44,CH023
2020-04-18,SO,Solothurn,0,1,338,11,1,70,2020-03-05,45,CH023
2020-04-19,SO,Solothurn,1,0,339,11,1,71,2020-03-05,46,CH023
2020-04-20,SO,Solothurn,9,0,348,11,0,71,2020-03-05,47,CH023
2020-04-21,SO,Solothurn,2,1,350,12,2,73,2020-03-05,48,CH023
2020-04-22,SO,Solothurn,6,2,356,14,1,74,2020-03-05,49,CH023
2020-04-23,SO,Solothurn,0,0,356,14,0,74,2020-03-05,50,CH023
2020-04-24,SO,Solothurn,3,0,359,14,1,75,2020-03-05,51,CH023
2020-04-25,SO,Solothurn,2,1,361,15,0,75,2020-03-05,52,CH023
2020-04-26,SO,Solothurn,0,0,361,15,0,75,2020-03-05,53,CH023
2020-04-27,SO,Solothurn,2,0,363,15,0,75,2020-03-05,54,CH023
2020-04-28,SO,Solothurn,3,0,366,15,2,77,2020-03-05,55,CH023
2020-04-29,SO,Solothurn,2,0,368,15,0,77,2020-03-05,56,CH023
2020-04-30,SO,Solothurn,2,0,370,15,0,77,2020-03-05,57,CH023
2020-05-01,SO,Solothurn,7,0,377,15,0,77,2020-03-05,58,CH023
2020-05-02,SO,Solothurn,2,0,379,15,0,77,2020-03-05,59,CH023
2020-05-03,SO,Solothurn,0,0,379,15,0,77,2020-03-05,60,CH023
2020-05-04,SO,Solothurn,1,0,380,15,0,77,2020-03-05,61,CH023
2020-05-05,SO,Solothurn,4,0,384,15,0,77,2020-03-05,62,CH023
2020-05-06,SO,Solothurn,1,0,385,15,0,77,2020-03-05,63,CH023
2020-05-07,SO,Solothurn,6,0,391,15,1,78,2020-03-05,64,CH023
2020-05-08,SO,Solothurn,5,0,396,15,0,78,2020-03-05,65,CH023
2020-05-09,SO,Solothurn,2,0,398,15,1,79,2020-03-05,66,CH023
2020-05-10,SO,Solothurn,1,0,399,15,1,80,2020-03-05,67,CH023
2020-05-11,SO,Solothurn,2,0,401,15,0,80,2020-03-05,68,CH023
2020-05-12,SO,Solothurn,2,0,403,15,0,80,2020-03-05,69,CH023
2020-05-13,SO,Solothurn,0,0,403,15,0,80,2020-03-05,70,CH023
2020-05-14,SO,Solothurn,0,0,403,15,0,80,2020-03-05,71,CH023
2020-05-15,SO,Solothurn,4,0,407,15,0,80,2020-03-05,72,CH023
2020-05-16,SO,Solothurn,1,0,408,15,0,80,2020-03-05,73,CH023
2020-05-17,SO,Solothurn,2,0,410,15,1,81,2020-03-05,74,CH023
2020-05-18,SO,Solothurn,1,0,411,15,0,81,2020-03-05,75,CH023
2020-05-19,SO,Solothurn,1,0,412,15,0,81,2020-03-05,76,CH023
2020-05-20,SO,Solothurn,0,0,412,15,0,81,2020-03-05,77,CH023
2020-05-21,SO,Solothurn,0,0,412,15,0,81,2020-03-05,78,CH023
2020-05-22,SO,Solothurn,0,0,412,15,0,81,2020-03-05,79,CH023
2020-05-23,SO,Solothurn,0,0,412,15,0,81,2020-03-05,80,CH023
2020-02-24,SZ,Schwyz,0,0,0,0,0,0,2020-03-02,-6,CH063
2020-02-25,SZ,Schwyz,0,0,0,0,0,0,2020-03-02,-5,CH063
2020-02-26,SZ,Schwyz,0,0,0,0,0,0,2020-03-02,-4,CH063
2020-02-27,SZ,Schwyz,0,0,0,0,0,0,2020-03-02,-3,CH063
2020-02-28,SZ,Schwyz,0,0,0,0,0,0,2020-03-02,-2,CH063
2020-02-29,SZ,Schwyz,0,0,0,0,1,1,2020-03-02,-1,CH063
2020-03-01,SZ,Schwyz,0,0,0,0,0,1,2020-03-02,0,CH063
2020-03-02,SZ,Schwyz,2,0,2,0,0,1,2020-03-02,1,CH063
2020-03-03,SZ,Schwyz,3,0,5,0,0,1,2020-03-02,2,CH063
2020-03-04,SZ,Schwyz,0,0,5,0,0,1,2020-03-02,3,CH063
2020-03-05,SZ,Schwyz,1,0,6,0,0,1,2020-03-02,4,CH063
2020-03-06,SZ,Schwyz,0,0,6,0,0,1,2020-03-02,5,CH063
2020-03-07,SZ,Schwyz,0,0,6,0,0,1,2020-03-02,6,CH063
2020-03-08,SZ,Schwyz,0,0,6,0,0,1,2020-03-02,7,CH063
2020-03-09,SZ,Schwyz,2,0,8,0,0,1,2020-03-02,8,CH063
2020-03-10,SZ,Schwyz,1,0,9,0,0,1,2020-03-02,9,CH063
2020-03-11,SZ,Schwyz,1,0,10,0,0,1,2020-03-02,10,CH063
2020-03-12,SZ,Schwyz,7,0,17,0,1,2,2020-03-02,11,CH063
2020-03-13,SZ,Schwyz,4,0,21,0,0,2,2020-03-02,12,CH063
2020-03-14,SZ,Schwyz,4,0,25,0,0,2,2020-03-02,13,CH063
2020-03-15,SZ,Schwyz,3,0,28,0,0,2,2020-03-02,14,CH063
2020-03-16,SZ,Schwyz,15,0,43,0,0,2,2020-03-02,15,CH063
2020-03-17,SZ,Schwyz,7,0,50,0,1,3,2020-03-02,16,CH063
2020-03-18,SZ,Schwyz,20,0,70,0,1,4,2020-03-02,17,CH063
2020-03-19,SZ,Schwyz,5,0,75,0,0,4,2020-03-02,18,CH063
2020-03-20,SZ,Schwyz,7,0,82,0,2,6,2020-03-02,19,CH063
2020-03-21,SZ,Schwyz,1,0,83,0,0,6,2020-03-02,20,CH063
2020-03-22,SZ,Schwyz,5,0,88,0,1,7,2020-03-02,21,CH063
2020-03-23,SZ,Schwyz,12,0,100,0,2,9,2020-03-02,22,CH063
2020-03-24,SZ,Schwyz,7,0,107,0,2,11,2020-03-02,23,CH063
2020-03-25,SZ,Schwyz,7,1,114,1,1,12,2020-03-02,24,CH063
2020-03-26,SZ,Schwyz,11,1,125,2,2,14,2020-03-02,25,CH063
2020-03-27,SZ,Schwyz,3,3,128,5,0,14,2020-03-02,26,CH063
2020-03-28,SZ,Schwyz,3,0,131,5,2,16,2020-03-02,27,CH063
2020-03-29,SZ,Schwyz,0,0,131,5,1,17,2020-03-02,28,CH063
2020-03-30,SZ,Schwyz,11,0,142,5,0,17,2020-03-02,29,CH063
2020-03-31,SZ,Schwyz,7,0,149,5,1,18,2020-03-02,30,CH063
2020-04-01,SZ,Schwyz,8,0,157,5,1,19,2020-03-02,31,CH063
2020-04-02,SZ,Schwyz,2,0,159,5,0,19,2020-03-02,32,CH063
2020-04-03,SZ,Schwyz,14,0,173,5,1,20,2020-03-02,33,CH063
2020-04-04,SZ,Schwyz,5,0,178,5,1,21,2020-03-02,34,CH063
2020-04-05,SZ,Schwyz,4,0,182,5,0,21,2020-03-02,35,CH063
2020-04-06,SZ,Schwyz,8,1,190,6,2,23,2020-03-02,36,CH063
2020-04-07,SZ,Schwyz,5,0,195,6,1,24,2020-03-02,37,CH063
2020-04-08,SZ,Schwyz,17,1,212,7,0,24,2020-03-02,38,CH063
2020-04-09,SZ,Schwyz,27,2,239,9,4,28,2020-03-02,39,CH063
2020-04-10,SZ,Schwyz,3,1,242,10,1,29,2020-03-02,40,CH063
2020-04-11,SZ,Schwyz,2,0,244,10,0,29,2020-03-02,41,CH063
2020-04-12,SZ,Schwyz,2,1,246,11,1,30,2020-03-02,42,CH063
2020-04-13,SZ,Schwyz,2,1,248,12,0,30,2020-03-02,43,CH063
2020-04-14,SZ,Schwyz,4,0,252,12,4,34,2020-03-02,44,CH063
2020-04-15,SZ,Schwyz,1,1,253,13,1,35,2020-03-02,45,CH063
2020-04-16,SZ,Schwyz,2,0,255,13,1,36,2020-03-02,46,CH063
2020-04-17,SZ,Schwyz,4,1,259,14,0,36,2020-03-02,47,CH063
2020-04-18,SZ,Schwyz,3,1,262,15,0,36,2020-03-02,48,CH063
2020-04-19,SZ,Schwyz,1,0,263,15,0,36,2020-03-02,49,CH063
2020-04-20,SZ,Schwyz,4,0,267,15,1,37,2020-03-02,50,CH063
2020-04-21,SZ,Schwyz,1,0,268,15,0,37,2020-03-02,51,CH063
2020-04-22,SZ,Schwyz,3,0,271,15,1,38,2020-03-02,52,CH063
2020-04-23,SZ,Schwyz,6,1,277,16,0,38,2020-03-02,53,CH063
2020-04-24,SZ,Schwyz,2,1,279,17,0,38,2020-03-02,54,CH063
2020-04-25,SZ,Schwyz,1,1,280,18,0,38,2020-03-02,55,CH063
2020-04-26,SZ,Schwyz,0,1,280,19,0,38,2020-03-02,56,CH063
2020-04-27,SZ,Schwyz,1,1,281,20,0,38,2020-03-02,57,CH063
2020-04-28,SZ,Schwyz,6,0,287,20,0,38,2020-03-02,58,CH063
2020-04-29,SZ,Schwyz,0,0,287,20,0,38,2020-03-02,59,CH063
2020-04-30,SZ,Schwyz,2,1,289,21,0,38,2020-03-02,60,CH063
2020-05-01,SZ,Schwyz,0,0,289,21,1,39,2020-03-02,61,CH063
2020-05-02,SZ,Schwyz,0,1,289,22,0,39,2020-03-02,62,CH063
2020-05-03,SZ,Schwyz,0,0,289,22,0,39,2020-03-02,63,CH063
2020-05-04,SZ,Schwyz,0,0,289,22,0,39,2020-03-02,64,CH063
2020-05-05,SZ,Schwyz,0,0,289,22,0,39,2020-03-02,65,CH063
2020-05-06,SZ,Schwyz,0,0,289,22,0,39,2020-03-02,66,CH063
2020-05-07,SZ,Schwyz,1,0,290,22,0,39,2020-03-02,67,CH063
2020-05-08,SZ,Schwyz,0,0,290,22,0,39,2020-03-02,68,CH063
2020-05-09,SZ,Schwyz,0,0,290,22,0,39,2020-03-02,69,CH063
2020-05-10,SZ,Schwyz,0,0,290,22,0,39,2020-03-02,70,CH063
2020-05-11,SZ,Schwyz,1,0,291,22,0,39,2020-03-02,71,CH063
2020-05-12,SZ,Schwyz,0,0,291,22,0,39,2020-03-02,72,CH063
2020-05-13,SZ,Schwyz,0,0,291,22,0,39,2020-03-02,73,CH063
2020-05-14,SZ,Schwyz,0,0,291,22,0,39,2020-03-02,74,CH063
2020-05-15,SZ,Schwyz,0,0,291,22,0,39,2020-03-02,75,CH063
2020-05-16,SZ,Schwyz,0,0,291,22,0,39,2020-03-02,76,CH063
2020-05-17,SZ,Schwyz,0,0,291,22,0,39,2020-03-02,77,CH063
2020-05-18,SZ,Schwyz,0,0,291,22,0,39,2020-03-02,78,CH063
2020-05-19,SZ,Schwyz,0,0,291,22,0,39,2020-03-02,79,CH063
2020-05-20,SZ,Schwyz,0,0,291,22,0,39,2020-03-02,80,CH063
2020-05-21,SZ,Schwyz,0,0,291,22,0,39,2020-03-02,81,CH063
2020-05-22,SZ,Schwyz,0,0,291,22,0,39,2020-03-02,82,CH063
2020-05-23,SZ,Schwyz,0,0,291,22,0,39,2020-03-02,83,CH063
2020-02-24,TG,Thurgau,0,0,0,0,1,1,2020-03-04,-8,CH057
2020-02-25,TG,Thurgau,0,0,0,0,0,1,2020-03-04,-7,CH057
2020-02-26,TG,Thurgau,0,0,0,0,0,1,2020-03-04,-6,CH057
2020-02-27,TG,Thurgau,0,0,0,0,0,1,2020-03-04,-5,CH057
2020-02-28,TG,Thurgau,0,0,0,0,0,1,2020-03-04,-4,CH057
2020-02-29,TG,Thurgau,0,0,0,0,0,1,2020-03-04,-3,CH057
2020-03-01,TG,Thurgau,0,0,0,0,0,1,2020-03-04,-2,CH057
2020-03-02,TG,Thurgau,0,0,0,0,0,1,2020-03-04,-1,CH057
2020-03-03,TG,Thurgau,0,0,0,0,0,1,2020-03-04,0,CH057
2020-03-04,TG,Thurgau,1,0,1,0,0,1,2020-03-04,1,CH057
2020-03-05,TG,Thurgau,0,0,1,0,0,1,2020-03-04,2,CH057
2020-03-06,TG,Thurgau,0,0,1,0,0,1,2020-03-04,3,CH057
2020-03-07,TG,Thurgau,0,0,1,0,0,1,2020-03-04,4,CH057
2020-03-08,TG,Thurgau,1,0,2,0,0,1,2020-03-04,5,CH057
2020-03-09,TG,Thurgau,2,0,4,0,0,1,2020-03-04,6,CH057
2020-03-10,TG,Thurgau,1,0,5,0,0,1,2020-03-04,7,CH057
2020-03-11,TG,Thurgau,1,0,6,0,0,1,2020-03-04,8,CH057
2020-03-12,TG,Thurgau,2,0,8,0,0,1,2020-03-04,9,CH057
2020-03-13,TG,Thurgau,7,0,15,0,0,1,2020-03-04,10,CH057
2020-03-14,TG,Thurgau,1,0,16,0,0,1,2020-03-04,11,CH057
2020-03-15,TG,Thurgau,2,0,18,0,1,2,2020-03-04,12,CH057
2020-03-16,TG,Thurgau,10,0,28,0,0,2,2020-03-04,13,CH057
2020-03-17,TG,Thurgau,10,0,38,0,3,5,2020-03-04,14,CH057
2020-03-18,TG,Thurgau,8,0,46,0,1,6,2020-03-04,15,CH057
2020-03-19,TG,Thurgau,5,0,51,0,2,8,2020-03-04,16,CH057
2020-03-20,TG,Thurgau,19,0,70,0,1,9,2020-03-04,17,CH057
2020-03-21,TG,Thurgau,3,0,73,0,1,10,2020-03-04,18,CH057
2020-03-22,TG,Thurgau,4,0,77,0,0,10,2020-03-04,19,CH057
2020-03-23,TG,Thurgau,10,0,87,0,2,12,2020-03-04,20,CH057
2020-03-24,TG,Thurgau,14,2,101,2,3,15,2020-03-04,21,CH057
2020-03-25,TG,Thurgau,7,0,108,2,1,16,2020-03-04,22,CH057
2020-03-26,TG,Thurgau,9,0,117,2,3,19,2020-03-04,23,CH057
2020-03-27,TG,Thurgau,17,0,134,2,3,22,2020-03-04,24,CH057
2020-03-28,TG,Thurgau,5,0,139,2,2,24,2020-03-04,25,CH057
2020-03-29,TG,Thurgau,3,0,142,2,5,29,2020-03-04,26,CH057
2020-03-30,TG,Thurgau,19,2,161,4,4,33,2020-03-04,27,CH057
2020-03-31,TG,Thurgau,12,0,173,4,1,34,2020-03-04,28,CH057
2020-04-01,TG,Thurgau,14,0,187,4,2,36,2020-03-04,29,CH057
2020-04-02,TG,Thurgau,14,1,201,5,3,39,2020-03-04,30,CH057
2020-04-03,TG,Thurgau,8,1,209,6,5,44,2020-03-04,31,CH057
2020-04-04,TG,Thurgau,6,0,215,6,3,47,2020-03-04,32,CH057
2020-04-05,TG,Thurgau,4,1,219,7,0,47,2020-03-04,33,CH057
2020-04-06,TG,Thurgau,20,0,239,7,5,52,2020-03-04,34,CH057
2020-04-07,TG,Thurgau,17,0,256,7,2,54,2020-03-04,35,CH057
2020-04-08,TG,Thurgau,7,0,263,7,1,55,2020-03-04,36,CH057
2020-04-09,TG,Thurgau,12,0,275,7,2,57,2020-03-04,37,CH057
2020-04-10,TG,Thurgau,6,0,281,7,0,57,2020-03-04,38,CH057
2020-04-11,TG,Thurgau,3,0,284,7,4,61,2020-03-04,39,CH057
2020-04-12,TG,Thurgau,3,1,287,8,1,62,2020-03-04,40,CH057
2020-04-13,TG,Thurgau,3,1,290,9,2,64,2020-03-04,41,CH057
2020-04-14,TG,Thurgau,6,1,296,10,1,65,2020-03-04,42,CH057
2020-04-15,TG,Thurgau,8,1,304,11,1,66,2020-03-04,43,CH057
2020-04-16,TG,Thurgau,7,0,311,11,0,66,2020-03-04,44,CH057
2020-04-17,TG,Thurgau,4,2,315,13,1,67,2020-03-04,45,CH057
2020-04-18,TG,Thurgau,5,0,320,13,0,67,2020-03-04,46,CH057
2020-04-19,TG,Thurgau,1,0,321,13,0,67,2020-03-04,47,CH057
2020-04-20,TG,Thurgau,15,1,336,14,0,67,2020-03-04,48,CH057
2020-04-21,TG,Thurgau,2,0,338,14,1,68,2020-03-04,49,CH057
2020-04-22,TG,Thurgau,2,0,340,14,0,68,2020-03-04,50,CH057
2020-04-23,TG,Thurgau,1,0,341,14,1,69,2020-03-04,51,CH057
2020-04-24,TG,Thurgau,0,1,341,15,0,69,2020-03-04,52,CH057
2020-04-25,TG,Thurgau,1,1,342,16,0,69,2020-03-04,53,CH057
2020-04-26,TG,Thurgau,0,0,342,16,0,69,2020-03-04,54,CH057
2020-04-27,TG,Thurgau,1,0,343,16,0,69,2020-03-04,55,CH057
2020-04-28,TG,Thurgau,2,0,345,16,0,69,2020-03-04,56,CH057
2020-04-29,TG,Thurgau,2,0,347,16,0,69,2020-03-04,57,CH057
2020-04-30,TG,Thurgau,1,0,348,16,0,69,2020-03-04,58,CH057
2020-05-01,TG,Thurgau,0,0,348,16,1,70,2020-03-04,59,CH057
2020-05-02,TG,Thurgau,0,0,348,16,0,70,2020-03-04,60,CH057
2020-05-03,TG,Thurgau,0,0,348,16,0,70,2020-03-04,61,CH057
2020-05-04,TG,Thurgau,1,0,349,16,0,70,2020-03-04,62,CH057
2020-05-05,TG,Thurgau,0,0,349,16,0,70,2020-03-04,63,CH057
2020-05-06,TG,Thurgau,0,0,349,16,0,70,2020-03-04,64,CH057
2020-05-07,TG,Thurgau,0,0,349,16,0,70,2020-03-04,65,CH057
2020-05-08,TG,Thurgau,1,0,350,16,0,70,2020-03-04,66,CH057
2020-05-09,TG,Thurgau,0,0,350,16,0,70,2020-03-04,67,CH057
2020-05-10,TG,Thurgau,0,0,350,16,0,70,2020-03-04,68,CH057
2020-05-11,TG,Thurgau,0,0,350,16,0,70,2020-03-04,69,CH057
2020-05-12,TG,Thurgau,1,0,351,16,0,70,2020-03-04,70,CH057
2020-05-13,TG,Thurgau,0,0,351,16,0,70,2020-03-04,71,CH057
2020-05-14,TG,Thurgau,0,0,351,16,0,70,2020-03-04,72,CH057
2020-05-15,TG,Thurgau,0,0,351,16,0,70,2020-03-04,73,CH057
2020-05-16,TG,Thurgau,0,0,351,16,0,70,2020-03-04,74,CH057
2020-05-17,TG,Thurgau,0,0,351,16,0,70,2020-03-04,75,CH057
2020-05-18,TG,Thurgau,0,0,351,16,0,70,2020-03-04,76,CH057
2020-05-19,TG,Thurgau,0,0,351,16,0,70,2020-03-04,77,CH057
2020-05-20,TG,Thurgau,0,0,351,16,0,70,2020-03-04,78,CH057
2020-05-21,TG,Thurgau,0,0,351,16,0,70,2020-03-04,79,CH057
2020-05-22,TG,Thurgau,0,0,351,16,0,70,2020-03-04,80,CH057
2020-05-23,TG,Thurgau,0,0,351,16,0,70,2020-03-04,81,CH057
2020-02-24,TI,Tessin,1,0,1,0,2,2,2020-02-24,1,CH070
2020-02-25,TI,Tessin,0,0,1,0,1,3,2020-02-24,2,CH070
2020-02-26,TI,Tessin,0,0,1,0,0,3,2020-02-24,3,CH070
2020-02-27,TI,Tessin,3,0,4,0,0,3,2020-02-24,4,CH070
2020-02-28,TI,Tessin,0,0,4,0,0,3,2020-02-24,5,CH070
2020-02-29,TI,Tessin,1,0,5,0,1,4,2020-02-24,6,CH070
2020-03-01,TI,Tessin,1,0,6,0,4,8,2020-02-24,7,CH070
2020-03-02,TI,Tessin,5,0,11,0,3,11,2020-02-24,8,CH070
2020-03-03,TI,Tessin,10,0,21,0,4,15,2020-02-24,9,CH070
2020-03-04,TI,Tessin,7,0,28,0,4,19,2020-02-24,10,CH070
2020-03-05,TI,Tessin,14,0,42,0,1,20,2020-02-24,11,CH070
2020-03-06,TI,Tessin,9,0,51,0,2,22,2020-02-24,12,CH070
2020-03-07,TI,Tessin,12,0,63,0,2,24,2020-02-24,13,CH070
2020-03-08,TI,Tessin,9,0,72,0,3,27,2020-02-24,14,CH070
2020-03-09,TI,Tessin,48,0,120,0,6,33,2020-02-24,15,CH070
2020-03-10,TI,Tessin,47,1,167,1,8,41,2020-02-24,16,CH070
2020-03-11,TI,Tessin,49,1,216,2,13,54,2020-02-24,17,CH070
2020-03-12,TI,Tessin,49,1,265,3,12,66,2020-02-24,18,CH070
2020-03-13,TI,Tessin,61,2,326,5,18,84,2020-02-24,19,CH070
2020-03-14,TI,Tessin,56,3,382,8,20,104,2020-02-24,20,CH070
2020-03-15,TI,Tessin,44,0,426,8,11,115,2020-02-24,21,CH070
2020-03-16,TI,Tessin,140,1,566,9,22,137,2020-02-24,22,CH070
2020-03-17,TI,Tessin,139,4,705,13,21,158,2020-02-24,23,CH070
2020-03-18,TI,Tessin,156,1,861,14,26,184,2020-02-24,24,CH070
2020-03-19,TI,Tessin,68,5,929,19,23,207,2020-02-24,25,CH070
2020-03-20,TI,Tessin,164,7,1093,26,40,247,2020-02-24,26,CH070
2020-03-21,TI,Tessin,78,6,1171,32,26,273,2020-02-24,27,CH070
2020-03-22,TI,Tessin,44,13,1215,45,33,306,2020-02-24,28,CH070
2020-03-23,TI,Tessin,183,5,1398,50,33,339,2020-02-24,29,CH070
2020-03-24,TI,Tessin,168,5,1566,55,39,378,2020-02-24,30,CH070
2020-03-25,TI,Tessin,138,6,1704,61,55,433,2020-02-24,31,CH070
2020-03-26,TI,Tessin,125,9,1829,70,29,462,2020-02-24,32,CH070
2020-03-27,TI,Tessin,177,5,2006,75,50,512,2020-02-24,33,CH070
2020-03-28,TI,Tessin,47,14,2053,89,22,534,2020-02-24,34,CH070
2020-03-29,TI,Tessin,27,7,2080,96,19,553,2020-02-24,35,CH070
2020-03-30,TI,Tessin,130,13,2210,109,30,583,2020-02-24,36,CH070
2020-03-31,TI,Tessin,99,10,2309,119,17,600,2020-02-24,37,CH070
2020-04-01,TI,Tessin,81,10,2390,129,18,618,2020-02-24,38,CH070
2020-04-02,TI,Tessin,61,13,2451,142,13,631,2020-02-24,39,CH070
2020-04-03,TI,Tessin,71,12,2522,154,7,638,2020-02-24,40,CH070
2020-04-04,TI,Tessin,31,10,2553,164,7,645,2020-02-24,41,CH070
2020-04-05,TI,Tessin,21,12,2574,176,4,649,2020-02-24,42,CH070
2020-04-06,TI,Tessin,94,6,2668,182,11,660,2020-02-24,43,CH070
2020-04-07,TI,Tessin,58,9,2726,191,7,667,2020-02-24,44,CH070
2020-04-08,TI,Tessin,43,9,2769,200,4,671,2020-02-24,45,CH070
2020-04-09,TI,Tessin,53,11,2822,211,6,677,2020-02-24,46,CH070
2020-04-10,TI,Tessin,38,3,2860,214,7,684,2020-02-24,47,CH070
2020-04-11,TI,Tessin,23,11,2883,225,7,691,2020-02-24,48,CH070
2020-04-12,TI,Tessin,10,3,2893,228,0,691,2020-02-24,49,CH070
2020-04-13,TI,Tessin,11,6,2904,234,5,696,2020-02-24,50,CH070
2020-04-14,TI,Tessin,34,4,2938,238,12,708,2020-02-24,51,CH070
2020-04-15,TI,Tessin,25,4,2963,242,3,711,2020-02-24,52,CH070
2020-04-16,TI,Tessin,25,2,2988,244,8,719,2020-02-24,53,CH070
2020-04-17,TI,Tessin,31,2,3019,246,12,731,2020-02-24,54,CH070
2020-04-18,TI,Tessin,13,4,3032,250,2,733,2020-02-24,55,CH070
2020-04-19,TI,Tessin,7,4,3039,254,4,737,2020-02-24,56,CH070
2020-04-20,TI,Tessin,27,4,3066,258,7,744,2020-02-24,57,CH070
2020-04-21,TI,Tessin,19,4,3085,262,3,747,2020-02-24,58,CH070
2020-04-22,TI,Tessin,10,2,3095,264,1,748,2020-02-24,59,CH070
2020-04-23,TI,Tessin,22,2,3117,266,0,748,2020-02-24,60,CH070
2020-04-24,TI,Tessin,18,6,3135,272,0,748,2020-02-24,61,CH070
2020-04-25,TI,Tessin,6,2,3141,274,0,748,2020-02-24,62,CH070
2020-04-26,TI,Tessin,4,4,3145,278,2,750,2020-02-24,63,CH070
2020-04-27,TI,Tessin,17,4,3162,282,1,751,2020-02-24,64,CH070
2020-04-28,TI,Tessin,13,2,3175,284,2,753,2020-02-24,65,CH070
2020-04-29,TI,Tessin,10,2,3185,286,0,753,2020-02-24,66,CH070
2020-04-30,TI,Tessin,10,1,3195,287,1,754,2020-02-24,67,CH070
2020-05-01,TI,Tessin,2,1,3197,288,1,755,2020-02-24,68,CH070
2020-05-02,TI,Tessin,3,0,3200,288,3,758,2020-02-24,69,CH070
2020-05-03,TI,Tessin,1,1,3201,289,0,758,2020-02-24,70,CH070
2020-05-04,TI,Tessin,9,3,3210,292,2,760,2020-02-24,71,CH070
2020-05-05,TI,Tessin,6,4,3216,296,2,762,2020-02-24,72,CH070
2020-05-06,TI,Tessin,4,1,3220,297,0,762,2020-02-24,73,CH070
2020-05-07,TI,Tessin,4,0,3224,297,2,764,2020-02-24,74,CH070
2020-05-08,TI,Tessin,5,4,3229,301,0,764,2020-02-24,75,CH070
2020-05-09,TI,Tessin,1,2,3230,303,0,764,2020-02-24,76,CH070
2020-05-10,TI,Tessin,0,0,3230,303,0,764,2020-02-24,77,CH070
2020-05-11,TI,Tessin,5,0,3235,303,0,764,2020-02-24,78,CH070
2020-05-12,TI,Tessin,3,0,3238,303,0,764,2020-02-24,79,CH070
2020-05-13,TI,Tessin,5,0,3243,303,0,764,2020-02-24,80,CH070
2020-05-14,TI,Tessin,1,0,3244,303,0,764,2020-02-24,81,CH070
2020-05-15,TI,Tessin,2,0,3246,303,1,765,2020-02-24,82,CH070
2020-05-16,TI,Tessin,2,0,3248,303,2,767,2020-02-24,83,CH070
2020-05-17,TI,Tessin,0,1,3248,304,1,768,2020-02-24,84,CH070
2020-05-18,TI,Tessin,4,0,3252,304,0,768,2020-02-24,85,CH070
2020-05-19,TI,Tessin,0,1,3252,305,0,768,2020-02-24,86,CH070
2020-05-20,TI,Tessin,0,0,3252,305,0,768,2020-02-24,87,CH070
2020-05-21,TI,Tessin,0,0,3252,305,0,768,2020-02-24,88,CH070
2020-05-22,TI,Tessin,0,0,3252,305,1,769,2020-02-24,89,CH070
2020-05-23,TI,Tessin,0,0,3252,305,0,769,2020-02-24,90,CH070
2020-02-24,UR,Uri,0,0,0,0,0,0,2020-03-16,-20,CH062
2020-02-25,UR,Uri,0,0,0,0,0,0,2020-03-16,-19,CH062
2020-02-26,UR,Uri,0,0,0,0,0,0,2020-03-16,-18,CH062
2020-02-27,UR,Uri,0,0,0,0,0,0,2020-03-16,-17,CH062
2020-02-28,UR,Uri,0,0,0,0,0,0,2020-03-16,-16,CH062
2020-02-29,UR,Uri,0,0,0,0,0,0,2020-03-16,-15,CH062
2020-03-01,UR,Uri,0,0,0,0,0,0,2020-03-16,-14,CH062
2020-03-02,UR,Uri,0,0,0,0,0,0,2020-03-16,-13,CH062
2020-03-03,UR,Uri,0,0,0,0,0,0,2020-03-16,-12,CH062
2020-03-04,UR,Uri,0,0,0,0,0,0,2020-03-16,-11,CH062
2020-03-05,UR,Uri,0,0,0,0,0,0,2020-03-16,-10,CH062
2020-03-06,UR,Uri,0,0,0,0,0,0,2020-03-16,-9,CH062
2020-03-07,UR,Uri,0,0,0,0,0,0,2020-03-16,-8,CH062
2020-03-08,UR,Uri,0,0,0,0,0,0,2020-03-16,-7,CH062
2020-03-09,UR,Uri,0,0,0,0,0,0,2020-03-16,-6,CH062
2020-03-10,UR,Uri,0,0,0,0,0,0,2020-03-16,-5,CH062
2020-03-11,UR,Uri,0,0,0,0,0,0,2020-03-16,-4,CH062
2020-03-12,UR,Uri,0,0,0,0,0,0,2020-03-16,-3,CH062
2020-03-13,UR,Uri,0,0,0,0,0,0,2020-03-16,-2,CH062
2020-03-14,UR,Uri,0,0,0,0,0,0,2020-03-16,-1,CH062
2020-03-15,UR,Uri,0,0,0,0,0,0,2020-03-16,0,CH062
2020-03-16,UR,Uri,1,0,1,0,0,0,2020-03-16,1,CH062
2020-03-17,UR,Uri,3,0,4,0,0,0,2020-03-16,2,CH062
2020-03-18,UR,Uri,1,0,5,0,0,0,2020-03-16,3,CH062
2020-03-19,UR,Uri,0,0,5,0,0,0,2020-03-16,4,CH062
2020-03-20,UR,Uri,4,0,9,0,1,1,2020-03-16,5,CH062
2020-03-21,UR,Uri,2,0,11,0,0,1,2020-03-16,6,CH062
2020-03-22,UR,Uri,7,0,18,0,2,3,2020-03-16,7,CH062
2020-03-23,UR,Uri,7,0,25,0,0,3,2020-03-16,8,CH062
2020-03-24,UR,Uri,6,0,31,0,0,3,2020-03-16,9,CH062
2020-03-25,UR,Uri,3,0,34,0,3,6,2020-03-16,10,CH062
2020-03-26,UR,Uri,5,0,39,0,1,7,2020-03-16,11,CH062
2020-03-27,UR,Uri,6,0,45,0,1,8,2020-03-16,12,CH062
2020-03-28,UR,Uri,3,0,48,0,0,8,2020-03-16,13,CH062
2020-03-29,UR,Uri,2,0,50,0,0,8,2020-03-16,14,CH062
2020-03-30,UR,Uri,4,0,54,0,0,8,2020-03-16,15,CH062
2020-03-31,UR,Uri,2,0,56,0,0,8,2020-03-16,16,CH062
2020-04-01,UR,Uri,3,1,59,1,1,9,2020-03-16,17,CH062
2020-04-02,UR,Uri,3,0,62,1,1,10,2020-03-16,18,CH062
2020-04-03,UR,Uri,2,0,64,1,0,10,2020-03-16,19,CH062
2020-04-04,UR,Uri,0,1,64,2,0,10,2020-03-16,20,CH062
2020-04-05,UR,Uri,0,0,64,2,1,11,2020-03-16,21,CH062
2020-04-06,UR,Uri,3,0,67,2,1,12,2020-03-16,22,CH062
2020-04-07,UR,Uri,0,1,67,3,0,12,2020-03-16,23,CH062
2020-04-08,UR,Uri,2,1,69,4,1,13,2020-03-16,24,CH062
2020-04-09,UR,Uri,1,0,70,4,0,13,2020-03-16,25,CH062
2020-04-10,UR,Uri,0,0,70,4,1,14,2020-03-16,26,CH062
2020-04-11,UR,Uri,1,0,71,4,0,14,2020-03-16,27,CH062
2020-04-12,UR,Uri,1,0,72,4,0,14,2020-03-16,28,CH062
2020-04-13,UR,Uri,0,0,72,4,0,14,2020-03-16,29,CH062
2020-04-14,UR,Uri,0,1,72,5,0,14,2020-03-16,30,CH062
2020-04-15,UR,Uri,1,0,73,5,0,14,2020-03-16,31,CH062
2020-04-16,UR,Uri,0,0,73,5,0,14,2020-03-16,32,CH062
2020-04-17,UR,Uri,0,0,73,5,0,14,2020-03-16,33,CH062
2020-04-18,UR,Uri,0,0,73,5,0,14,2020-03-16,34,CH062
2020-04-19,UR,Uri,0,0,73,5,0,14,2020-03-16,35,CH062
2020-04-20,UR,Uri,0,0,73,5,0,14,2020-03-16,36,CH062
2020-04-21,UR,Uri,0,0,73,5,0,14,2020-03-16,37,CH062
2020-04-22,UR,Uri,0,0,73,5,0,14,2020-03-16,38,CH062
2020-04-23,UR,Uri,0,0,73,5,0,14,2020-03-16,39,CH062
2020-04-24,UR,Uri,2,0,75,5,0,14,2020-03-16,40,CH062
2020-04-25,UR,Uri,0,0,75,5,0,14,2020-03-16,41,CH062
2020-04-26,UR,Uri,4,0,79,5,0,14,2020-03-16,42,CH062
2020-04-27,UR,Uri,1,0,80,5,0,14,2020-03-16,43,CH062
2020-04-28,UR,Uri,0,0,80,5,0,14,2020-03-16,44,CH062
2020-04-29,UR,Uri,1,0,81,5,0,14,2020-03-16,45,CH062
2020-04-30,UR,Uri,1,1,82,6,0,14,2020-03-16,46,CH062
2020-05-01,UR,Uri,3,0,85,6,0,14,2020-03-16,47,CH062
2020-05-02,UR,Uri,0,0,85,6,0,14,2020-03-16,48,CH062
2020-05-03,UR,Uri,1,0,86,6,0,14,2020-03-16,49,CH062
2020-05-04,UR,Uri,0,0,86,6,0,14,2020-03-16,50,CH062
2020-05-05,UR,Uri,1,0,87,6,0,14,2020-03-16,51,CH062
2020-05-06,UR,Uri,1,0,88,6,0,14,2020-03-16,52,CH062
2020-05-07,UR,Uri,0,0,88,6,0,14,2020-03-16,53,CH062
2020-05-08,UR,Uri,0,0,88,6,0,14,2020-03-16,54,CH062
2020-05-09,UR,Uri,0,0,88,6,0,14,2020-03-16,55,CH062
2020-05-10,UR,Uri,0,0,88,6,0,14,2020-03-16,56,CH062
2020-05-11,UR,Uri,0,0,88,6,0,14,2020-03-16,57,CH062
2020-05-12,UR,Uri,0,0,88,6,0,14,2020-03-16,58,CH062
2020-05-13,UR,Uri,0,0,88,6,0,14,2020-03-16,59,CH062
2020-05-14,UR,Uri,1,0,89,6,0,14,2020-03-16,60,CH062
2020-05-15,UR,Uri,0,0,89,6,0,14,2020-03-16,61,CH062
2020-05-16,UR,Uri,0,0,89,6,0,14,2020-03-16,62,CH062
2020-05-17,UR,Uri,0,0,89,6,0,14,2020-03-16,63,CH062
2020-05-18,UR,Uri,0,0,89,6,0,14,2020-03-16,64,CH062
2020-05-19,UR,Uri,0,0,89,6,0,14,2020-03-16,65,CH062
2020-05-20,UR,Uri,0,0,89,6,0,14,2020-03-16,66,CH062
2020-05-21,UR,Uri,0,0,89,6,0,14,2020-03-16,67,CH062
2020-05-22,UR,Uri,0,0,89,6,0,14,2020-03-16,68,CH062
2020-05-23,UR,Uri,0,0,89,6,0,14,2020-03-16,69,CH062
2020-02-24,VD,Waadt,0,0,0,0,1,1,2020-02-26,-1,CH011
2020-02-25,VD,Waadt,0,0,0,0,2,3,2020-02-26,0,CH011
2020-02-26,VD,Waadt,1,0,1,0,0,3,2020-02-26,1,CH011
2020-02-27,VD,Waadt,0,0,1,0,0,3,2020-02-26,2,CH011
2020-02-28,VD,Waadt,0,0,1,0,1,4,2020-02-26,3,CH011
2020-02-29,VD,Waadt,0,0,1,0,2,6,2020-02-26,4,CH011
2020-03-01,VD,Waadt,0,0,1,0,1,7,2020-02-26,5,CH011
2020-03-02,VD,Waadt,5,0,6,0,1,8,2020-02-26,6,CH011
2020-03-03,VD,Waadt,4,0,10,0,2,10,2020-02-26,7,CH011
2020-03-04,VD,Waadt,8,0,18,0,0,10,2020-02-26,8,CH011
2020-03-05,VD,Waadt,11,1,29,1,5,15,2020-02-26,9,CH011
2020-03-06,VD,Waadt,8,0,37,1,6,21,2020-02-26,10,CH011
2020-03-07,VD,Waadt,11,0,48,1,2,23,2020-02-26,11,CH011
2020-03-08,VD,Waadt,10,0,58,1,4,27,2020-02-26,12,CH011
2020-03-09,VD,Waadt,36,0,94,1,8,35,2020-02-26,13,CH011
2020-03-10,VD,Waadt,40,0,134,1,9,44,2020-02-26,14,CH011
2020-03-11,VD,Waadt,74,1,208,2,7,51,2020-02-26,15,CH011
2020-03-12,VD,Waadt,75,1,283,3,10,61,2020-02-26,16,CH011
2020-03-13,VD,Waadt,97,0,380,3,10,71,2020-02-26,17,CH011
2020-03-14,VD,Waadt,107,1,487,4,16,87,2020-02-26,18,CH011
2020-03-15,VD,Waadt,93,1,580,5,13,100,2020-02-26,19,CH011
2020-03-16,VD,Waadt,237,2,817,7,23,123,2020-02-26,20,CH011
2020-03-17,VD,Waadt,248,2,1065,9,10,133,2020-02-26,21,CH011
2020-03-18,VD,Waadt,270,3,1335,12,18,151,2020-02-26,22,CH011
2020-03-19,VD,Waadt,216,1,1551,13,22,173,2020-02-26,23,CH011
2020-03-20,VD,Waadt,241,5,1792,18,22,195,2020-02-26,24,CH011
2020-03-21,VD,Waadt,121,3,1913,21,27,222,2020-02-26,25,CH011
2020-03-22,VD,Waadt,105,2,2018,23,20,242,2020-02-26,26,CH011
2020-03-23,VD,Waadt,311,5,2329,28,19,261,2020-02-26,27,CH011
2020-03-24,VD,Waadt,269,2,2598,30,32,293,2020-02-26,28,CH011
2020-03-25,VD,Waadt,192,8,2790,38,21,314,2020-02-26,29,CH011
2020-03-26,VD,Waadt,206,14,2996,52,18,332,2020-02-26,30,CH011
2020-03-27,VD,Waadt,238,2,3234,54,32,364,2020-02-26,31,CH011
2020-03-28,VD,Waadt,132,7,3366,61,10,374,2020-02-26,32,CH011
2020-03-29,VD,Waadt,88,7,3454,68,14,388,2020-02-26,33,CH011
2020-03-30,VD,Waadt,214,9,3668,77,16,404,2020-02-26,34,CH011
2020-03-31,VD,Waadt,162,7,3830,84,30,434,2020-02-26,35,CH011
2020-04-01,VD,Waadt,151,8,3981,92,14,448,2020-02-26,36,CH011
2020-04-02,VD,Waadt,136,16,4117,108,9,457,2020-02-26,37,CH011
2020-04-03,VD,Waadt,138,15,4255,123,13,470,2020-02-26,38,CH011
2020-04-04,VD,Waadt,71,5,4326,128,6,476,2020-02-26,39,CH011
2020-04-05,VD,Waadt,41,10,4367,138,8,484,2020-02-26,40,CH011
2020-04-06,VD,Waadt,117,12,4484,150,8,492,2020-02-26,41,CH011
2020-04-07,VD,Waadt,83,12,4567,162,4,496,2020-02-26,42,CH011
2020-04-08,VD,Waadt,93,6,4660,168,6,502,2020-02-26,43,CH011
2020-04-09,VD,Waadt,96,5,4756,173,10,512,2020-02-26,44,CH011
2020-04-10,VD,Waadt,51,5,4807,178,9,521,2020-02-26,45,CH011
2020-04-11,VD,Waadt,40,5,4847,183,9,530,2020-02-26,46,CH011
2020-04-12,VD,Waadt,39,8,4886,191,6,536,2020-02-26,47,CH011
2020-04-13,VD,Waadt,44,4,4930,195,2,538,2020-02-26,48,CH011
2020-04-14,VD,Waadt,70,7,5000,202,5,543,2020-02-26,49,CH011
2020-04-15,VD,Waadt,51,11,5051,213,2,545,2020-02-26,50,CH011
2020-04-16,VD,Waadt,30,10,5081,223,5,550,2020-02-26,51,CH011
2020-04-17,VD,Waadt,33,4,5114,227,4,554,2020-02-26,52,CH011
2020-04-18,VD,Waadt,19,4,5133,231,2,556,2020-02-26,53,CH011
2020-04-19,VD,Waadt,11,4,5144,235,1,557,2020-02-26,54,CH011
2020-04-20,VD,Waadt,33,10,5177,245,0,557,2020-02-26,55,CH011
2020-04-21,VD,Waadt,33,5,5210,250,1,558,2020-02-26,56,CH011
2020-04-22,VD,Waadt,22,4,5232,254,4,562,2020-02-26,57,CH011
2020-04-23,VD,Waadt,31,8,5263,262,0,562,2020-02-26,58,CH011
2020-04-24,VD,Waadt,23,2,5286,264,1,563,2020-02-26,59,CH011
2020-04-25,VD,Waadt,13,10,5299,274,0,563,2020-02-26,60,CH011
2020-04-26,VD,Waadt,9,3,5308,277,0,563,2020-02-26,61,CH011
2020-04-27,VD,Waadt,19,4,5327,281,3,566,2020-02-26,62,CH011
2020-04-28,VD,Waadt,23,2,5350,283,2,568,2020-02-26,63,CH011
2020-04-29,VD,Waadt,14,1,5364,284,1,569,2020-02-26,64,CH011
2020-04-30,VD,Waadt,12,2,5376,286,1,570,2020-02-26,65,CH011
2020-05-01,VD,Waadt,14,4,5390,290,0,570,2020-02-26,66,CH011
2020-05-02,VD,Waadt,9,3,5399,293,0,570,2020-02-26,67,CH011
2020-05-03,VD,Waadt,5,2,5404,295,1,571,2020-02-26,68,CH011
2020-05-04,VD,Waadt,9,0,5413,295,0,571,2020-02-26,69,CH011
2020-05-05,VD,Waadt,11,0,5424,295,1,572,2020-02-26,70,CH011
2020-05-06,VD,Waadt,18,0,5442,295,0,572,2020-02-26,71,CH011
2020-05-07,VD,Waadt,5,1,5447,296,0,572,2020-02-26,72,CH011
2020-05-08,VD,Waadt,11,0,5458,296,0,572,2020-02-26,73,CH011
2020-05-09,VD,Waadt,7,0,5465,296,1,573,2020-02-26,74,CH011
2020-05-10,VD,Waadt,0,1,5465,297,1,574,2020-02-26,75,CH011
2020-05-11,VD,Waadt,7,0,5472,297,2,576,2020-02-26,76,CH011
2020-05-12,VD,Waadt,9,0,5481,297,0,576,2020-02-26,77,CH011
2020-05-13,VD,Waadt,8,0,5489,297,0,576,2020-02-26,78,CH011
2020-05-14,VD,Waadt,5,1,5494,298,0,576,2020-02-26,79,CH011
2020-05-15,VD,Waadt,4,0,5498,298,0,576,2020-02-26,80,CH011
2020-05-16,VD,Waadt,0,0,5498,298,0,576,2020-02-26,81,CH011
2020-05-17,VD,Waadt,2,0,5500,298,0,576,2020-02-26,82,CH011
2020-05-18,VD,Waadt,4,0,5504,298,0,576,2020-02-26,83,CH011
2020-05-19,VD,Waadt,3,0,5507,298,0,576,2020-02-26,84,CH011
2020-05-20,VD,Waadt,0,0,5507,298,0,576,2020-02-26,85,CH011
2020-05-21,VD,Waadt,0,0,5507,298,0,576,2020-02-26,86,CH011
2020-05-22,VD,Waadt,0,0,5507,298,0,576,2020-02-26,87,CH011
2020-05-23,VD,Waadt,0,0,5507,298,0,576,2020-02-26,88,CH011
2020-02-24,VS,Wallis,0,0,0,0,0,0,2020-02-28,-3,CH012
2020-02-25,VS,Wallis,0,0,0,0,0,0,2020-02-28,-2,CH012
2020-02-26,VS,Wallis,0,0,0,0,0,0,2020-02-28,-1,CH012
2020-02-27,VS,Wallis,0,0,0,0,0,0,2020-02-28,0,CH012
2020-02-28,VS,Wallis,1,0,1,0,1,1,2020-02-28,1,CH012
2020-02-29,VS,Wallis,0,0,1,0,0,1,2020-02-28,2,CH012
2020-03-01,VS,Wallis,1,0,2,0,1,2,2020-02-28,3,CH012
2020-03-02,VS,Wallis,2,0,4,0,0,2,2020-02-28,4,CH012
2020-03-03,VS,Wallis,0,0,4,0,1,3,2020-02-28,5,CH012
2020-03-04,VS,Wallis,1,0,5,0,1,4,2020-02-28,6,CH012
2020-03-05,VS,Wallis,1,0,6,0,0,4,2020-02-28,7,CH012
2020-03-06,VS,Wallis,0,0,6,0,3,7,2020-02-28,8,CH012
2020-03-07,VS,Wallis,1,0,7,0,0,7,2020-02-28,9,CH012
2020-03-08,VS,Wallis,6,0,13,0,3,10,2020-02-28,10,CH012
2020-03-09,VS,Wallis,4,0,17,0,1,11,2020-02-28,11,CH012
2020-03-10,VS,Wallis,5,0,22,0,3,14,2020-02-28,12,CH012
2020-03-11,VS,Wallis,7,0,29,0,3,17,2020-02-28,13,CH012
2020-03-12,VS,Wallis,25,0,54,0,6,23,2020-02-28,14,CH012
2020-03-13,VS,Wallis,16,1,70,1,2,25,2020-02-28,15,CH012
2020-03-14,VS,Wallis,21,0,91,1,2,27,2020-02-28,16,CH012
2020-03-15,VS,Wallis,10,2,101,3,3,30,2020-02-28,17,CH012
2020-03-16,VS,Wallis,60,1,161,4,5,35,2020-02-28,18,CH012
2020-03-17,VS,Wallis,52,0,213,4,5,40,2020-02-28,19,CH012
2020-03-18,VS,Wallis,81,0,294,4,7,47,2020-02-28,20,CH012
2020-03-19,VS,Wallis,38,2,332,6,6,53,2020-02-28,21,CH012
2020-03-20,VS,Wallis,95,0,427,6,8,61,2020-02-28,22,CH012
2020-03-21,VS,Wallis,51,2,478,8,10,71,2020-02-28,23,CH012
2020-03-22,VS,Wallis,37,0,515,8,6,77,2020-02-28,24,CH012
2020-03-23,VS,Wallis,96,1,611,9,12,89,2020-02-28,25,CH012
2020-03-24,VS,Wallis,99,1,710,10,7,96,2020-02-28,26,CH012
2020-03-25,VS,Wallis,69,1,779,11,10,106,2020-02-28,27,CH012
2020-03-26,VS,Wallis,76,1,855,12,9,115,2020-02-28,28,CH012
2020-03-27,VS,Wallis,92,2,947,14,13,128,2020-02-28,29,CH012
2020-03-28,VS,Wallis,44,3,991,17,6,134,2020-02-28,30,CH012
2020-03-29,VS,Wallis,34,6,1025,23,10,144,2020-02-28,31,CH012
2020-03-30,VS,Wallis,85,4,1110,27,10,154,2020-02-28,32,CH012
2020-03-31,VS,Wallis,68,1,1178,28,8,162,2020-02-28,33,CH012
2020-04-01,VS,Wallis,69,1,1247,29,4,166,2020-02-28,34,CH012
2020-04-02,VS,Wallis,47,3,1294,32,12,178,2020-02-28,35,CH012
2020-04-03,VS,Wallis,49,2,1343,34,4,182,2020-02-28,36,CH012
2020-04-04,VS,Wallis,33,2,1376,36,2,184,2020-02-28,37,CH012
2020-04-05,VS,Wallis,15,4,1391,40,3,187,2020-02-28,38,CH012
2020-04-06,VS,Wallis,68,2,1459,42,4,191,2020-02-28,39,CH012
2020-04-07,VS,Wallis,38,5,1497,47,5,196,2020-02-28,40,CH012
2020-04-08,VS,Wallis,36,5,1533,52,3,199,2020-02-28,41,CH012
2020-04-09,VS,Wallis,26,3,1559,55,2,201,2020-02-28,42,CH012
2020-04-10,VS,Wallis,31,5,1590,60,2,203,2020-02-28,43,CH012
2020-04-11,VS,Wallis,24,2,1614,62,1,204,2020-02-28,44,CH012
2020-04-12,VS,Wallis,13,4,1627,66,2,206,2020-02-28,45,CH012
2020-04-13,VS,Wallis,14,1,1641,67,0,206,2020-02-28,46,CH012
2020-04-14,VS,Wallis,28,0,1669,67,3,209,2020-02-28,47,CH012
2020-04-15,VS,Wallis,13,0,1682,67,2,211,2020-02-28,48,CH012
2020-04-16,VS,Wallis,17,1,1699,68,1,212,2020-02-28,49,CH012
2020-04-17,VS,Wallis,17,3,1716,71,1,213,2020-02-28,50,CH012
2020-04-18,VS,Wallis,9,3,1725,74,0,213,2020-02-28,51,CH012
2020-04-19,VS,Wallis,9,3,1734,77,0,213,2020-02-28,52,CH012
2020-04-20,VS,Wallis,19,1,1753,78,3,216,2020-02-28,53,CH012
2020-04-21,VS,Wallis,8,4,1761,82,0,216,2020-02-28,54,CH012
2020-04-22,VS,Wallis,7,3,1768,85,0,216,2020-02-28,55,CH012
2020-04-23,VS,Wallis,15,3,1783,88,0,216,2020-02-28,56,CH012
2020-04-24,VS,Wallis,9,1,1792,89,1,217,2020-02-28,57,CH012
2020-04-25,VS,Wallis,5,2,1797,91,4,221,2020-02-28,58,CH012
2020-04-26,VS,Wallis,2,0,1799,91,2,223,2020-02-28,59,CH012
2020-04-27,VS,Wallis,18,1,1817,92,0,223,2020-02-28,60,CH012
2020-04-28,VS,Wallis,10,1,1827,93,0,223,2020-02-28,61,CH012
2020-04-29,VS,Wallis,7,0,1834,93,0,223,2020-02-28,62,CH012
2020-04-30,VS,Wallis,6,0,1840,93,0,223,2020-02-28,63,CH012
2020-05-01,VS,Wallis,4,0,1844,93,0,223,2020-02-28,64,CH012
2020-05-02,VS,Wallis,2,1,1846,94,1,224,2020-02-28,65,CH012
2020-05-03,VS,Wallis,2,2,1848,96,0,224,2020-02-28,66,CH012
2020-05-04,VS,Wallis,8,0,1856,96,0,224,2020-02-28,67,CH012
2020-05-05,VS,Wallis,2,2,1858,98,0,224,2020-02-28,68,CH012
2020-05-06,VS,Wallis,3,0,1861,98,0,224,2020-02-28,69,CH012
2020-05-07,VS,Wallis,1,0,1862,98,0,224,2020-02-28,70,CH012
2020-05-08,VS,Wallis,4,2,1866,100,0,224,2020-02-28,71,CH012
2020-05-09,VS,Wallis,1,0,1867,100,0,224,2020-02-28,72,CH012
2020-05-10,VS,Wallis,1,0,1868,100,0,224,2020-02-28,73,CH012
2020-05-11,VS,Wallis,4,2,1872,102,0,224,2020-02-28,74,CH012
2020-05-12,VS,Wallis,0,0,1872,102,0,224,2020-02-28,75,CH012
2020-05-13,VS,Wallis,1,0,1873,102,0,224,2020-02-28,76,CH012
2020-05-14,VS,Wallis,2,0,1875,102,0,224,2020-02-28,77,CH012
2020-05-15,VS,Wallis,9,0,1884,102,0,224,2020-02-28,78,CH012
2020-05-16,VS,Wallis,3,0,1887,102,0,224,2020-02-28,79,CH012
2020-05-17,VS,Wallis,0,0,1887,102,0,224,2020-02-28,80,CH012
2020-05-18,VS,Wallis,2,2,1889,104,1,225,2020-02-28,81,CH012
2020-05-19,VS,Wallis,1,0,1890,104,0,225,2020-02-28,82,CH012
2020-05-20,VS,Wallis,0,0,1890,104,0,225,2020-02-28,83,CH012
2020-05-21,VS,Wallis,0,0,1890,104,0,225,2020-02-28,84,CH012
2020-05-22,VS,Wallis,0,0,1890,104,1,226,2020-02-28,85,CH012
2020-05-23,VS,Wallis,0,0,1890,104,0,226,2020-02-28,86,CH012
2020-02-24,ZG,Zug,0,0,0,0,0,0,2020-03-01,-5,CH066
2020-02-25,ZG,Zug,0,0,0,0,0,0,2020-03-01,-4,CH066
2020-02-26,ZG,Zug,0,0,0,0,0,0,2020-03-01,-3,CH066
2020-02-27,ZG,Zug,0,0,0,0,0,0,2020-03-01,-2,CH066
2020-02-28,ZG,Zug,0,0,0,0,0,0,2020-03-01,-1,CH066
2020-02-29,ZG,Zug,0,0,0,0,0,0,2020-03-01,0,CH066
2020-03-01,ZG,Zug,1,0,1,0,0,0,2020-03-01,1,CH066
2020-03-02,ZG,Zug,2,0,3,0,0,0,2020-03-01,2,CH066
2020-03-03,ZG,Zug,3,0,6,0,1,1,2020-03-01,3,CH066
2020-03-04,ZG,Zug,1,0,7,0,1,2,2020-03-01,4,CH066
2020-03-05,ZG,Zug,0,0,7,0,0,2,2020-03-01,5,CH066
2020-03-06,ZG,Zug,0,0,7,0,0,2,2020-03-01,6,CH066
2020-03-07,ZG,Zug,0,0,7,0,0,2,2020-03-01,7,CH066
2020-03-08,ZG,Zug,0,0,7,0,0,2,2020-03-01,8,CH066
2020-03-09,ZG,Zug,0,0,7,0,0,2,2020-03-01,9,CH066
2020-03-10,ZG,Zug,0,0,7,0,0,2,2020-03-01,10,CH066
2020-03-11,ZG,Zug,1,0,8,0,0,2,2020-03-01,11,CH066
2020-03-12,ZG,Zug,4,0,12,0,0,2,2020-03-01,12,CH066
2020-03-13,ZG,Zug,1,0,13,0,0,2,2020-03-01,13,CH066
2020-03-14,ZG,Zug,4,0,17,0,0,2,2020-03-01,14,CH066
2020-03-15,ZG,Zug,0,0,17,0,0,2,2020-03-01,15,CH066
2020-03-16,ZG,Zug,4,0,21,0,0,2,2020-03-01,16,CH066
2020-03-17,ZG,Zug,10,0,31,0,1,3,2020-03-01,17,CH066
2020-03-18,ZG,Zug,4,0,35,0,0,3,2020-03-01,18,CH066
2020-03-19,ZG,Zug,2,0,37,0,0,3,2020-03-01,19,CH066
2020-03-20,ZG,Zug,8,0,45,0,0,3,2020-03-01,20,CH066
2020-03-21,ZG,Zug,5,0,50,0,0,3,2020-03-01,21,CH066
2020-03-22,ZG,Zug,0,0,50,0,0,3,2020-03-01,22,CH066
2020-03-23,ZG,Zug,4,0,54,0,1,4,2020-03-01,23,CH066
2020-03-24,ZG,Zug,7,0,61,0,0,4,2020-03-01,24,CH066
2020-03-25,ZG,Zug,7,0,68,0,1,5,2020-03-01,25,CH066
2020-03-26,ZG,Zug,5,0,73,0,1,6,2020-03-01,26,CH066
2020-03-27,ZG,Zug,7,1,80,1,1,7,2020-03-01,27,CH066
2020-03-28,ZG,Zug,5,0,85,1,1,8,2020-03-01,28,CH066
2020-03-29,ZG,Zug,2,0,87,1,2,10,2020-03-01,29,CH066
2020-03-30,ZG,Zug,7,0,94,1,3,13,2020-03-01,30,CH066
2020-03-31,ZG,Zug,3,0,97,1,2,15,2020-03-01,31,CH066
2020-04-01,ZG,Zug,12,0,109,1,1,16,2020-03-01,32,CH066
2020-04-02,ZG,Zug,6,1,115,2,1,17,2020-03-01,33,CH066
2020-04-03,ZG,Zug,7,0,122,2,1,18,2020-03-01,34,CH066
2020-04-04,ZG,Zug,4,0,126,2,1,19,2020-03-01,35,CH066
2020-04-05,ZG,Zug,2,0,128,2,1,20,2020-03-01,36,CH066
2020-04-06,ZG,Zug,4,0,132,2,0,20,2020-03-01,37,CH066
2020-04-07,ZG,Zug,2,0,134,2,0,20,2020-03-01,38,CH066
2020-04-08,ZG,Zug,3,0,137,2,2,22,2020-03-01,39,CH066
2020-04-09,ZG,Zug,2,0,139,2,0,22,2020-03-01,40,CH066
2020-04-10,ZG,Zug,0,1,139,3,1,23,2020-03-01,41,CH066
2020-04-11,ZG,Zug,0,0,139,3,0,23,2020-03-01,42,CH066
2020-04-12,ZG,Zug,2,0,141,3,0,23,2020-03-01,43,CH066
2020-04-13,ZG,Zug,1,0,142,3,0,23,2020-03-01,44,CH066
2020-04-14,ZG,Zug,0,1,142,4,0,23,2020-03-01,45,CH066
2020-04-15,ZG,Zug,1,0,143,4,0,23,2020-03-01,46,CH066
2020-04-16,ZG,Zug,2,0,145,4,0,23,2020-03-01,47,CH066
2020-04-17,ZG,Zug,0,1,145,5,0,23,2020-03-01,48,CH066
2020-04-18,ZG,Zug,1,0,146,5,0,23,2020-03-01,49,CH066
2020-04-19,ZG,Zug,0,0,146,5,0,23,2020-03-01,50,CH066
2020-04-20,ZG,Zug,0,1,146,6,0,23,2020-03-01,51,CH066
2020-04-21,ZG,Zug,1,0,147,6,0,23,2020-03-01,52,CH066
2020-04-22,ZG,Zug,3,0,150,6,0,23,2020-03-01,53,CH066
2020-04-23,ZG,Zug,1,0,151,6,0,23,2020-03-01,54,CH066
2020-04-24,ZG,Zug,3,0,154,6,0,23,2020-03-01,55,CH066
2020-04-25,ZG,Zug,1,0,155,6,0,23,2020-03-01,56,CH066
2020-04-26,ZG,Zug,0,0,155,6,0,23,2020-03-01,57,CH066
2020-04-27,ZG,Zug,1,0,156,6,0,23,2020-03-01,58,CH066
2020-04-28,ZG,Zug,2,0,158,6,0,23,2020-03-01,59,CH066
2020-04-29,ZG,Zug,2,0,160,6,0,23,2020-03-01,60,CH066
2020-04-30,ZG,Zug,0,0,160,6,0,23,2020-03-01,61,CH066
2020-05-01,ZG,Zug,1,0,161,6,0,23,2020-03-01,62,CH066
2020-05-02,ZG,Zug,1,0,162,6,0,23,2020-03-01,63,CH066
2020-05-03,ZG,Zug,0,0,162,6,0,23,2020-03-01,64,CH066
2020-05-04,ZG,Zug,0,0,162,6,0,23,2020-03-01,65,CH066
2020-05-05,ZG,Zug,1,0,163,6,0,23,2020-03-01,66,CH066
2020-05-06,ZG,Zug,0,0,163,6,0,23,2020-03-01,67,CH066
2020-05-07,ZG,Zug,0,0,163,6,0,23,2020-03-01,68,CH066
2020-05-08,ZG,Zug,0,0,163,6,0,23,2020-03-01,69,CH066
2020-05-09,ZG,Zug,0,0,163,6,0,23,2020-03-01,70,CH066
2020-05-10,ZG,Zug,0,0,163,6,0,23,2020-03-01,71,CH066
2020-05-11,ZG,Zug,0,0,163,6,0,23,2020-03-01,72,CH066
2020-05-12,ZG,Zug,1,0,164,6,0,23,2020-03-01,73,CH066
2020-05-13,ZG,Zug,1,0,165,6,0,23,2020-03-01,74,CH066
2020-05-14,ZG,Zug,2,0,167,6,0,23,2020-03-01,75,CH066
2020-05-15,ZG,Zug,0,0,167,6,0,23,2020-03-01,76,CH066
2020-05-16,ZG,Zug,0,0,167,6,0,23,2020-03-01,77,CH066
2020-05-17,ZG,Zug,0,0,167,6,0,23,2020-03-01,78,CH066
2020-05-18,ZG,Zug,0,0,167,6,0,23,2020-03-01,79,CH066
2020-05-19,ZG,Zug,0,0,167,6,0,23,2020-03-01,80,CH066
2020-05-20,ZG,Zug,0,0,167,6,0,23,2020-03-01,81,CH066
2020-05-21,ZG,Zug,0,0,167,6,0,23,2020-03-01,82,CH066
2020-05-22,ZG,Zug,0,0,167,6,0,23,2020-03-01,83,CH066
2020-05-23,ZG,Zug,0,0,167,6,0,23,2020-03-01,84,CH066
2020-02-24,ZH,Zürich,0,0,0,0,0,0,2020-02-26,-1,CH040
2020-02-25,ZH,Zürich,0,0,0,0,0,0,2020-02-26,0,CH040
2020-02-26,ZH,Zürich,1,0,1,0,1,1,2020-02-26,1,CH040
2020-02-27,ZH,Zürich,1,0,2,0,2,3,2020-02-26,2,CH040
2020-02-28,ZH,Zürich,0,0,2,0,0,3,2020-02-26,3,CH040
2020-02-29,ZH,Zürich,4,0,6,0,5,8,2020-02-26,4,CH040
2020-03-01,ZH,Zürich,2,0,8,0,1,9,2020-02-26,5,CH040
2020-03-02,ZH,Zürich,5,0,13,0,0,9,2020-02-26,6,CH040
2020-03-03,ZH,Zürich,1,0,14,0,2,11,2020-02-26,7,CH040
2020-03-04,ZH,Zürich,5,0,19,0,0,11,2020-02-26,8,CH040
2020-03-05,ZH,Zürich,5,0,24,0,2,13,2020-02-26,9,CH040
2020-03-06,ZH,Zürich,5,0,29,0,1,14,2020-02-26,10,CH040
2020-03-07,ZH,Zürich,7,0,36,0,1,15,2020-02-26,11,CH040
2020-03-08,ZH,Zürich,6,0,42,0,1,16,2020-02-26,12,CH040
2020-03-09,ZH,Zürich,13,0,55,0,1,17,2020-02-26,13,CH040
2020-03-10,ZH,Zürich,33,0,88,0,1,18,2020-02-26,14,CH040
2020-03-11,ZH,Zürich,40,0,128,0,7,25,2020-02-26,15,CH040
2020-03-12,ZH,Zürich,38,0,166,0,3,28,2020-02-26,16,CH040
2020-03-13,ZH,Zürich,52,0,218,0,4,32,2020-02-26,17,CH040
2020-03-14,ZH,Zürich,34,0,252,0,5,37,2020-02-26,18,CH040
2020-03-15,ZH,Zürich,38,1,290,1,4,41,2020-02-26,19,CH040
2020-03-16,ZH,Zürich,132,0,422,1,8,49,2020-02-26,20,CH040
2020-03-17,ZH,Zürich,130,0,552,1,11,60,2020-02-26,21,CH040
2020-03-18,ZH,Zürich,134,1,686,2,10,70,2020-02-26,22,CH040
2020-03-19,ZH,Zürich,134,1,820,3,11,81,2020-02-26,23,CH040
2020-03-20,ZH,Zürich,141,1,961,4,10,91,2020-02-26,24,CH040
2020-03-21,ZH,Zürich,70,1,1031,5,7,98,2020-02-26,25,CH040
2020-03-22,ZH,Zürich,50,1,1081,6,13,111,2020-02-26,26,CH040
2020-03-23,ZH,Zürich,173,0,1254,6,8,119,2020-02-26,27,CH040
2020-03-24,ZH,Zürich,138,1,1392,7,15,134,2020-02-26,28,CH040
2020-03-25,ZH,Zürich,111,2,1503,9,19,153,2020-02-26,29,CH040
2020-03-26,ZH,Zürich,113,3,1616,12,15,168,2020-02-26,30,CH040
2020-03-27,ZH,Zürich,160,2,1776,14,18,186,2020-02-26,31,CH040
2020-03-28,ZH,Zürich,71,4,1847,18,11,197,2020-02-26,32,CH040
2020-03-29,ZH,Zürich,39,3,1886,21,15,212,2020-02-26,33,CH040
2020-03-30,ZH,Zürich,158,1,2044,22,9,221,2020-02-26,34,CH040
2020-03-31,ZH,Zürich,129,2,2173,24,16,237,2020-02-26,35,CH040
2020-04-01,ZH,Zürich,115,9,2288,33,12,249,2020-02-26,36,CH040
2020-04-02,ZH,Zürich,115,3,2403,36,13,262,2020-02-26,37,CH040
2020-04-03,ZH,Zürich,133,2,2536,38,10,272,2020-02-26,38,CH040
2020-04-04,ZH,Zürich,43,7,2579,45,9,281,2020-02-26,39,CH040
2020-04-05,ZH,Zürich,22,4,2601,49,9,290,2020-02-26,40,CH040
2020-04-06,ZH,Zürich,97,2,2698,51,6,296,2020-02-26,41,CH040
2020-04-07,ZH,Zürich,87,2,2785,53,4,300,2020-02-26,42,CH040
2020-04-08,ZH,Zürich,60,8,2845,61,10,310,2020-02-26,43,CH040
2020-04-09,ZH,Zürich,52,2,2897,63,9,319,2020-02-26,44,CH040
2020-04-10,ZH,Zürich,34,5,2931,68,5,324,2020-02-26,45,CH040
2020-04-11,ZH,Zürich,18,6,2949,74,6,330,2020-02-26,46,CH040
2020-04-12,ZH,Zürich,31,2,2980,76,3,333,2020-02-26,47,CH040
2020-04-13,ZH,Zürich,17,4,2997,80,2,335,2020-02-26,48,CH040
2020-04-14,ZH,Zürich,55,4,3052,84,2,337,2020-02-26,49,CH040
2020-04-15,ZH,Zürich,28,4,3080,88,2,339,2020-02-26,50,CH040
2020-04-16,ZH,Zürich,39,4,3119,92,8,347,2020-02-26,51,CH040
2020-04-17,ZH,Zürich,29,5,3148,97,2,349,2020-02-26,52,CH040
2020-04-18,ZH,Zürich,13,5,3161,102,0,349,2020-02-26,53,CH040
2020-04-19,ZH,Zürich,8,0,3169,102,4,353,2020-02-26,54,CH040
2020-04-20,ZH,Zürich,28,2,3197,104,2,355,2020-02-26,55,CH040
2020-04-21,ZH,Zürich,35,2,3232,106,1,356,2020-02-26,56,CH040
2020-04-22,ZH,Zürich,20,1,3252,107,4,360,2020-02-26,57,CH040
2020-04-23,ZH,Zürich,24,3,3276,110,1,361,2020-02-26,58,CH040
2020-04-24,ZH,Zürich,27,1,3303,111,4,365,2020-02-26,59,CH040
2020-04-25,ZH,Zürich,15,1,3318,112,3,368,2020-02-26,60,CH040
2020-04-26,ZH,Zürich,9,0,3327,112,0,368,2020-02-26,61,CH040
2020-04-27,ZH,Zürich,21,4,3348,116,2,370,2020-02-26,62,CH040
2020-04-28,ZH,Zürich,23,0,3371,116,1,371,2020-02-26,63,CH040
2020-04-29,ZH,Zürich,6,2,3377,118,2,373,2020-02-26,64,CH040
2020-04-30,ZH,Zürich,11,2,3388,120,1,374,2020-02-26,65,CH040
2020-05-01,ZH,Zürich,0,0,3388,120,1,375,2020-02-26,66,CH040
2020-05-02,ZH,Zürich,4,0,3392,120,0,375,2020-02-26,67,CH040
2020-05-03,ZH,Zürich,1,0,3393,120,2,377,2020-02-26,68,CH040
2020-05-04,ZH,Zürich,18,0,3411,120,1,378,2020-02-26,69,CH040
2020-05-05,ZH,Zürich,13,1,3424,121,1,379,2020-02-26,70,CH040
2020-05-06,ZH,Zürich,11,1,3435,122,0,379,2020-02-26,71,CH040
2020-05-07,ZH,Zürich,6,0,3441,122,3,382,2020-02-26,72,CH040
2020-05-08,ZH,Zürich,4,0,3445,122,0,382,2020-02-26,73,CH040
2020-05-09,ZH,Zürich,1,1,3446,123,0,382,2020-02-26,74,CH040
2020-05-10,ZH,Zürich,2,0,3448,123,2,384,2020-02-26,75,CH040
2020-05-11,ZH,Zürich,6,0,3454,123,0,384,2020-02-26,76,CH040
2020-05-12,ZH,Zürich,7,0,3461,123,0,384,2020-02-26,77,CH040
2020-05-13,ZH,Zürich,1,0,3462,123,0,384,2020-02-26,78,CH040
2020-05-14,ZH,Zürich,4,0,3466,123,0,384,2020-02-26,79,CH040
2020-05-15,ZH,Zürich,4,1,3470,124,0,384,2020-02-26,80,CH040
2020-05-16,ZH,Zürich,2,0,3472,124,1,385,2020-02-26,81,CH040
2020-05-17,ZH,Zürich,4,0,3476,124,0,385,2020-02-26,82,CH040
2020-05-18,ZH,Zürich,2,0,3478,124,0,385,2020-02-26,83,CH040
2020-05-19,ZH,Zürich,0,0,3478,124,0,385,2020-02-26,84,CH040
2020-05-20,ZH,Zürich,0,0,3478,124,0,385,2020-02-26,85,CH040
2020-05-21,ZH,Zürich,0,0,3478,124,1,386,2020-02-26,86,CH040
2020-05-22,ZH,Zürich,0,0,3478,124,2,388,2020-02-26,87,CH040
2020-05-23,ZH,Zürich,0,0,3478,124,1,389,2020-02-26,88,CH040
